a	un/una
a	un/una
aardvark	aardvark
aardvark	aardvark
aardvarks	aardvarks
aback	hacia atrás
aback	hacia atrás
aback	hacia atrás
abacterial	abacterial
abacus	ábaco
abacus	ábaco
abacus	ábaco
abacuses	abacuses
abacuses	abacuses
abacuses	abacuses
abaft	abaft
abalone	abalone
abalones	abalones
abandon	abandonar
abandon	abandonar
abandoned	abandoned
abandoned	abandoned
abandoned	abandoned
abandonee	abandonee
abandoner	abandoner
abandoning	abandoning
abandonment	abandono
abandonment	abandono
abandonments	abandonments
abase	rebajar
abased	abased
abasement	abasement
abasements	abasements
abases	abases
abash	confundir
abashed	abashed
abashed	abashed
abasing	abasing
abate	disminuir/decrecer
abate	disminuir/decrecer
abated	abated
abatement	reducción
abatement	reducción
abatements	abatements
abates	abates
abating	abating
abating	abating
abattoir	carnicería
abbe	abbe
abberations	abberations
abbey	abadía
abbey	abadía
abbeys	abbeys
abbot	abad
abbot	abad
abbot	abad
abbot	abad
abbot	abad
abbots	abbots
abbreviate	abreviar
abbreviate	abreviar
abbreviated	abbreviated
abbreviates	abbreviates
abbreviating	abbreviating
abbreviation	abreviación
abbreviation	abreviación
abbreviation	abreviación
abbreviations	abbreviations
abbreviations	abbreviations
abbreviator	abbreviator
abdicable	abdicable
abdicate	abdicar
abdicate	abdicar
abdicated	abdicated
abdication	abdicación
abdicator	abdicator
abdomen	abdomen
abdomen	abdomen
abdomens	abdomens
abdominal	abdominal
abdominally	abdominally
abduct	abducir
abducted	abducted
abducting	abducting
abduction	secuestro
abductions	abductions
abductor	secuestrador
abductors	abductors
abeam	abeam
abecedarian	abecedarian
abed	abed
aberrance	desvío
aberrant	aberrante
aberrantly	aberrantly
aberration	aberración
aberration	aberración
aberrations	aberrations
abet	instigar
abetment	abetment
abets	abets
abetted	abetted
abetter	abetter
abetting	abetting
abettor	abettor
abeyance	suspensión
abeyant	abeyant
abhor	aborrecer
abhorred	abhorred
abhorrence	horror
abhorrent	horrible
abhorrently	abhorrently
abhorring	abhorring
abhors	abhors
abide	aguardar
abided	abided
abides	abides
abiding	continuo
abilities	abilities
ability	capacidad
ability	capacidad
abiotic	abiotic
abject	miserable/pobre
abjection	abjection
abjectly	abjectly
abjuration	abjuration
abjure	abjurar
abjurer	abjurer
ablation	ablation
ablative	ablative
ablaze	ablaze
ablaze	ablaze
able	capaz/hábil
able	capaz/hábil
able	capaz/hábil
able	capaz/hábil
abler	abler
ablest	ablest
abloom	abloom
ablution	ablution
ablutions	ablutions
ably	hábilmente
abnegate	abnegate
abnegates	abnegates
abnegation	abnegation
abnormal	anormal
abnormal	anormal
abnormal	anormal
abnormalities	abnormalities
abnormality	anormalidad
abnormally	irregularmente
aboard	a bordo
abode	abode
abodes	abodes
aboil	aboil
abolish	abolir
abolish	abolir
abolishable	abolishable
abolished	abolished
abolisher	abolisher
abolishes	abolishes
abolishment	supresión
abolition	abolición
abolition	abolición
abolitionism	abolitionism
abolitionist	abolitionist
abolitionists	abolitionists
abominable	abominable
abominably	abominably
abominate	abominar
abomination	aversión/horror
abominations	abominations
aboriginal	indígena
aboriginally	aboriginally
aborigine	aborigine
aborigines	aborigines
abort	abortar
aborted	aborted
aborter	aborter
aborting	aborting
abortion	aborto
abortion	aborto
abortionist	abortionist
abortionists	abortionists
abortions	abortions
abortive	abortivo
abortively	abortively
aborts	aborts
abound	abundar
about	cerca
above	encima de
aboveboard	aboveboard
aboveground	aboveground
abovementioned	abovementioned
abovementioned	abovementioned
abracadabra	abracadabra
abradable	abradable
abrade	abrade
abrasion	abrasion
abrasions	abrasions
abrasive	afilado
abrasives	abrasives
abreast	abreast
abridge	abreviar
abridged	abridged
abridgement	resumen
abridging	abridging
abroad	en el extranjero
abrogate	abrogar
abrogated	abrogated
abrogation	abolición
abrupt	escarpado
abruptly	abruptamente
abruptness	abruptness
abscess	absceso
abscesses	abscesses
abscond	abscond
absconded	absconded
absence	ausencia/falta
absences	absences
absent	ausente
absentee	ausente
absenteeism	absenteeism
absentees	absentees
absently	absently
absentminded	absentminded
absentmindedly	absentmindedly
absentmindedly	absentmindedly
absentmindedness	absentmindedness
absinth	absinth
absinthe	absinthe
absolute	absoluto
absolutely	absolutamente
absolution	absolution
absolutism	absolutism
absolve	absolver
absolved	absolved
absolving	absolving
absorb	abssorber
absorbability	absorbability
absorbable	absorbable
absorbant	absorbant
absorbed	absorbed
absorbent	absorbent
absorbing	absorbing
absorption	absorption
abstain	abstenerse
abstained	abstained
abstemious	abstemious
abstention	abstention
abstentions	abstentions
abstinence	abstinence
abstinent	abstinent
abstinently	abstinently
abstract	decudir
abstract	decudir
abstraction	robo
abstruse	abstruse
absurd	absurd
absurdism	absurdism
absurdist	absurdist
absurdities	absurdities
absurdity	absurdity
abundance	riqueza
abundant	abundante
abundantly	abundantly
abuse	ofender
abused	abused
abusive	abusive
abusively	abusively
abut	abut
abuzz	abuzz
abysmal	abysmal
abysmally	abysmally
abyss	abismo
abyss	abismo
abysses	abysses
abysses	abysses
acacia	acacia
academic	estudiante
academical	academical
academically	academically
academician	academician
academies	academies
academism	academism
academy	academia
acanthus	acanthus
acanthuses	acanthuses
accede	acordar
accede	acordar
accelerate	acelerar
accelerated	accelerated
acceleration	acceleration
accelerations	accelerations
accelerator	acelerador
accelerators	accelerators
accelerometer	accelerometer
accelerometers	accelerometers
accent	acento
accented	accented
accented	accented
accents	accents
accentual	accentual
accentually	accentually
accentuate	acentuar
accentuated	accentuated
accentuation	accentuation
accept	aceptar
acceptability	aceptabilidad
acceptable	aceptable
acceptably	acceptably
acceptance	aceptación
accepted	accepted
accepter	accepter
acceptor	acceptor
access	acometida
accessed	accessed
accessibility	accessibility
accessible	alcanzable
accession	adquisición
accessorial	accessorial
accessories	accessories
accessorize	accessorize
accessors	accessors
accessory	apéndice
accident	accidente
accidental	accidental
accidentalism	accidentalism
accidentalist	accidentalist
accidentally	accidentally
accidently	accidently
accidents	accidents
acclaim	aplaudir
acclamation	aplauso
acclimate	acclimate
acclimated	acclimated
acclimatize	aclimatar
accolade	accolade
accolades	accolades
accommodate	acomodar
accommodated	accommodated
accommodating	oficioso/servicial
accommodation	acuerdo
accommodations	accommodations
accompanied	accompanied
accompanier	accompanier
accompanies	accompanies
accompaniment	accompaniment
accompaniments	accompaniments
accompanist	accompanist
accompanists	accompanists
accompany	acompañar
accompanyist	accompanyist
accompanyists	accompanyists
accomplice	accomplice
accomplices	accomplices
accomplish	realizar
accomplished	accomplished
accomplishment	accomplishment
accomplishments	accomplishments
accord	acorde
accordance	accordance
accorder	accorder
accorders	accorders
accordion	acordeón
accordionist	accordionist
accordionists	accordionists
accordions	accordions
accords	accords
accost	accost
account	cuenta
accountability	accountability
accountable	accountable
accountant	contador público
accounting	accounting
accouterment	accouterment
accrued	accrued
accruement	accruement
accumulated	accumulated
acetaminophen	acetaminophen
acetify	acetify
acetone	acetone
acid	agrio
acidic	acidic
allergen	allergen
allergen	allergen
allergic	allergic
allergies	allergies
allergies	allergies
allergy	alergia
allergy	alergia
alleviate	alleviate
alleviated	alleviated
alley	calleja
alley	calleja
alleys	alleys
alleys	alleys
alliance	alliance
alliance	alliance
alliances	alliances
alliances	alliances
allied	allied
allied	allied
alligator	alligator
alligator	alligator
alligators	alligators
alligators	alligators
alliteration	alliteration
alliteration	alliteration
alliterations	alliterations
alliterations	alliterations
allocate	allocate
allocated	allocated
allocation	allocation
allocation	allocation
allocations	allocations
allocution	allocution
allocution	allocution
allocution	allocution
allot	allot
allow	permitir
allowable	allowable
allowance	allowance
allowed	allowed
alloy	alloy
alphabet	alfabeto
alphabetic	alphabetic
alphabetical	alphabetical
alphabetization	alphabetization
alphabetizations	alphabetizations
alphabetize	alfabetizar
alphabetized	alphabetized
alphabetizing	alphabetizing
alphabets	alphabets
alphamerical	alphamerical
alphanumeric	alphanumeric
alphanumerical	alphanumerical
alphanumerically	alphanumerically
alphanumerics	alphanumerics
alpine	alpine
alpinism	alpinism
alpinist	alpinist
already	ya
also	también
altercation	altercation
altercations	altercations
alternate	alternar
alternated	alternated
alternately	alternately
among	entre
amoral	amoral
amorous	amorous
amorously	amorously
amorphous	amorphous
amount	número/suma
amount	número/suma
amp	amp
ampere	ampere
ampersand	ampersand
amphetamine	amphetamine
and	y
anyway	anyway
anywhere	anywhere
aorta	aorta
apace	apace
apart	aparte
apartheid	apartheid
apartment	apartamento
apathetic	apathetic
apathy	apathy
ape	mono
ape	mono
aperitif	aperitif
aperture	abetura
apex	apex
aphid	aphid
arrive	llegar
aspen	aspen
audit	controlar
auditorium	aula magna
auditoriums	auditoriums
audits	audits
available	disponible
babble	babble
babbler	babbler
babies	babies
baboon	baboon
baby	bebé
baccalaureate	baccalaureate
baccarat	baccarat
bachelor	solterón
bachelors	bachelors
bacilli	bacilli
bacillus	bacillus
back	reverso
backache	backache
backbite	backbite
backbone	backbone
background	fondo
backgrounds	backgrounds
backside	backside
backslide	backslide
backup	backup
backward	atrasado
bacon	tocino
bacteria	bacteria
bad	malo
badge	badge
badged	badged
badgers	badgers
badinage	badinage
bag	bolso
bagatelle	bagatelle
bagatelles	bagatelles
baggage	equipaje/equipajes
bags	bags
baguette	baguette
bah	bah
bail	bail
bait	carnada/cebo
bake	bake
baker	panadero
bakeries	bakeries
bakers	bakers
bakery	panadería
bakeshop	bakeshop
balance	balance
balconies	balconies
balcony	balcón
bald	bald
baldhead	baldhead
baldly	baldly
baldness	baldness
bale	bale
baleen	baleen
balk	balk
ball	pelota
ballad	ballad
ballade	ballade
ballads	ballads
ballast	lastre
ballet	ballet
balletic	balletic
balloon	globo
ballot	balotaje
balls	balls
ballyhoo	ballyhoo
balm	bálsamo
bamboo	bambú
bamboozle	bamboozle
banana	plátano
bananas	bananas
band	tira
bandage	vendaje
bandeau	bandeau
bandit	bandido
bandits	bandits
bandleader	bandleader
bandmaster	bandmaster
bane	bane
banished	banished
barb	barb
barbarian	bárbaro
barbarians	barbarians
barbarism	barbarism
barber	barbero
barmaid	barmaid
barman	barman
barracks	cuartel
beach	playa
bear	parir/oso
bear	parir/oso
bed	cauce
bedroom	bedroom
believe	creer
betray	betray
bibliographic	bibliographic
bibliographies	bibliographies
bibliography	bibliography
blackberry	zarzamora
book	libro
boomerang	boomerang
boxer	boxeador
boy	chico/muchacho
boys	boys
brain	cerebro
brood	brood
broom	escoba
broth	broth
build	construir
building	construcción
bye	adiós
cab	cabriolé
cabal	cabal
cabala	cabala
cabalism	cabalism
cabalist	cabalist
cabalistic	cabalistic
caballero	caballero
cabaret	cabarét
cabbage	col
cabbages	cabbages
cabdriver	cabdriver
cabin	cabana
cabinet	armario
cabinetmaker	cabinetmaker
cabinetmakers	cabinetmakers
cabinets	cabinets
cabins	cabins
cable	cable
cabled	cabled
cablegram	cablegram
cablegrams	cablegrams
cables	cables
cabling	cabling
cabman	cabman
caboose	caboose
cabotage	cabotage
cabriolet	cabriolet
cabs	cabs
cacao	cacao
cacciatore	cacciatore
cachalot	cachalot
cache	cache
cachepot	cachepot
caches	caches
cackle	cackle
cackled	cackled
cackles	cackles
cackling	cackling
cacophony	cacophony
cacti	cacti
cactus	cacto
cad	cad
cadaver	cadaver
cadaverous	cadaverous
caddies	caddies
caddy	caddy
cadence	cadence
cadet	cadet
cadetship	cadetship
cadge	cadge
cadger	cadger
cafe	cafe
cafes	cafes
cafeteria	cafeteria
cafeterias	cafeterias
caffeine	caffeine
caftan	caftan
cage	cage
cages	cages
cahier	cahier
cairn	cairn
cairns	cairns
caitiff	caitiff
cajole	cajole
cajoler	cajoler
cajolery	cajolery
cake	queque
cake	queque
calcium	calcium
calculate	calcular
calculated	calculated
calibrate	calibrate
calibrated	calibrated
calibration	calibration
car	automóvil/coche
carbonization	carbonization
carbonize	carbonize
carbonized	carbonized
carbonless	carbonless
carburetor	carburetor
carburetors	carburetors
carburization	carburization
carburize	carburize
card	carda
cardamom	cardamom
cardiac	cardiac
cardigan	cardigan
cardioid	cardioid
cardioids	cardioids
care	cuidar/cuidado
care	cuidar/cuidado
cared	cared
career	carrera
careful	circunspecto/prudente
carefully	carefully
cat	gato
cell	célula
cellular	cellular
chance	probabilidad/oportunidad
cherries	cerezas
church	iglesia
churches	churches
cloak	capa
cloaks	cloaks
clock	reloj
clockmaker	clockmaker
clockwise	clockwise
cloister	cloister
clone	clone
cloud	nube
clouds	clouds
coal	carbon
computer	computador
computers	ordenadores
comrades	comrades
concealed	concealed
conjuring	conjuring
contemplate	contemplate
contemplate	contemplate
contemplate	contemplate
contemplates	contemplates
contemplation	contemplation
contemplation	contemplation
contemplation	contemplation
contemplations	contemplations
contemplations	contemplations
contemplative	contemplative
contemporaneous	contemporaneous
contemporaneously	contemporaneously
contemporaries	contemporaries
contemporaries	contemporaries
contemporary	contemporary
contemporary	contemporary
contempt	desprecio
contempt	desprecio
contemptible	contemptible
contemptibly	contemptibly
contemptuous	contemptuous
contemptuous	contemptuous
contemptuously	contemptuously
contemptuously	contemptuously
contend	contend
contend	contend
contend	contend
contender	contender
contender	contender
contender	contender
contenders	contenders
contenders	contenders
contenders	contenders
contending	contending
contending	contending
contends	contends
contends	contends
content	content
content	content
content	content
contented	contento
contented	contento
contentedly	contentedly
contentedness	contentedness
contention	contention
contention	contention
contention	contention
contentions	contentions
contentions	contentions
contentions	contentions
contentious	contentious
contentious	contentious
contentment	contentment
contents	contents
contents	contents
contest	concurso
contest	concurso
contest	concurso
contestant	contestant
contestant	contestant
cot	camita de niño
coterie	trinquete
cotillion	cotillion
cotillon	cotillon
cottage	cottage
cottager	cottager
couch	canapé
cough	toser
coughs	coughs
count	calcular/computar
countenance	countenance
counteract	counteract
counterbalance	counterbalance
countermand	anular/contramandar
countermarch	countermarch
counterplot	counterplot
counterpoint	counterpoint
counterpoise	counterpoise
counterweight	counterweight
countess	countess
countless	countless
country	campo/país
countryman	countryman
countrywide	countrywide
county	county
couple	embragar
couplet	couplet
coupon	cupón
courage	valor
courageous	courageous
courageously	courageously
courier	mensajero
course	cursillo/curso/plato
courser	courser
court	grave/patio
courteous	cortés
courteously	courteously
courteousness	courteousness
courtesy	courtesy
courthouse	courthouse
courtier	courtier
courtliness	courtliness
courtly	courtly
courtmartial	courtmartial
courtroom	courtroom
courtship	courtship
cousin	prima/primo
cove	cove
covenant	covenant
cover	cubrir
covert	covert
covet	covet
covetous	covetous
covetously	covetously
cow	vaca
cow	vaca
coward	coward
cowardice	cowardice
cowardly	cowardly
cower	cower
cowherd	cowherd
cowl	cowl
coxcomb	coxcomb
coy	coy
coyly	coyly
coyness	coyness
coyote	coyote
cozily	cozily
cozy	cozy
crabapple	crabapple
crabbed	crabbed
crack	hendedura
cracker	cracker
crackle	crackle
cradle	cradle
craft	astucia
craftily	craftily
crag	crag
cram	cram
cramp	cramp
cranberry	cranberry
crane	grúa
cranium	cranium
crankiness	crankiness
cranky	cranky
crape	crape
crash	choque
crate	crate
crater	crater
crave	crave
craven	craven
crawl	crawl
crayfish	cangrejo
crayon	crayon
craze	craze
crazily	crazily
crazy	crazy
creak	creak
cream	crema/desnatar
creamy	creamy
crease	crease
create	cree
creation	creacion
creator	creator
creature	creature
credence	credence
credential	credential
credit	haber
creditable	creditable
creditably	creditably
creditor	creditor
credo	credo
credulity	credulity
credulous	credulous
credulously	credulously
creed	creed
creek	creek
creep	creep
creeps	creeps
cremate	cremate
cut	cortar
cute	cute
cute	cute
cuteness	cuteness
cutoffs	cutoffs
cutout	cutout
cuts	corta
cutter	cutter
cutting	cutting
cyanate	cyanate
cyanide	cyanide
cybernetic	cybernetic
cybernetician	cybernetician
cybernetics	cybernetics
cycle	bicicleta/ciclo
cyclic	cyclic
cyclical	cyclical
cyclist	cyclist
cyclists	cyclists
cycloid	cycloid
cycloidal	cycloidal
cyclone	ciclón
cyclonic	cyclonic
cyclopean	cyclopean
cyclotron	cyclotron
cylinder	cilindro
dad	papa
daddies	daddies
daddy	papa
dads	dads
daffy	daffy
daft	daft
dagger	daga
dahlia	dahlia
dahlias	dahlias
daily	todos los días/a diario
daintier	daintier
dainty	amable/fino
dairy	lechería
dalmatian	dalmatian
dalmatians	dalmatians
dam	obstrucción/presa
damage	daño
damage	daño
damage	daño
damage	daño
damaged	estropeado
damaged	estropeado
damager	damager
damagers	damagers
damages	damages
damaging	damaging
dame	dame
dammit	dammit
damnation	damnation
damned	damned
damp	humedo
dampen	dampen
dampened	dampened
dampness	dampness
dams	dams
dance	bailar/baile
dancer	dancer
dancers	dancers
dancing	dancing
dandelion	dandelion
dandelions	dandelions
dandies	dandies
dandruff	caspa
danger	peligro
dangerous	peligroso
dart	dardo
day	día
daybreak	amanecer
daylight	daylight
days	días
deactivate	deactivate
deactivation	deactivation
dead	muerto
deaf	sordo
deaths	deaths
deep	profundo
density	density
deserve	deserve
detat	detat
detre	detre
device	aparato
device	aparato
dictated	dictated
dictates	dictates
dictation	dictation
dictations	dictations
dictionaries	dictionaries
dictionary	diccionario
did	did
die	morir
died	died
diesel	diesel
diet	dieta
dietetically	dietetically
diets	diets
different	diferente/disferente
difficulties	difficulties
difficulty	inconveniente
dig	cavar
digested	digested
dignitaries	dignitaries
dignities	dignities
dignity	dignity
dilate	dilate
dilated	dilated
doctor	doctor/médico
doeuvre	doeuvre
dog	perro
doggie	doggie
dogs	perros
drink	bebida/beber
drinks	drinks
drive	propulsión
drizzle	drizzle
dry	seco/árido
duck	pato
each	cada
eagle	águila
eagles	eagles
eaglet	eaglet
ear	oreja
earache	earache
eardrum	eardrum
eardrums	eardrums
earlobe	earlobe
early	temprano
earn	ganar
earning	earning
earphones	earphones
earring	earring
earrings	arete
ears	ears
earth	tierra
earthquake	terremoto
earthquakes	earthquakes
earths	earths
earthworm	earthworm
earthworms	earthworms
earwax	earwax
ease	ease
easel	caballete
easier	easier
easiest	easiest
easily	fácilmente
easiness	easiness
east	este
easter	pascua
easy	fácil
eat	comer
eatable	eatable
eats	eats
ebony	ebony
eccentric	eccentric
eccentricity	eccentricity
ecclesiastic	ecclesiastic
echo	echo
eclipse	eclipse
ecologic	ecologic
ecologist	ecologist
ecology	ecology
economics	economics
ecru	ecru
eight	ocho
eighteen	dieciocho/diez y ocho
eighteenth	decimooctavo
eightfold	eightfold
eighth	octavo
eighties	eighties
eightieth	eightieth
eighty	ochenta
eightyfold	eightyfold
einsteinium	einsteinium
either	either
ejaculate	ejaculate
ejaculated	ejaculated
ejaculates	ejaculates
ejaculating	ejaculating
ejaculation	ejaculation
ejaculations	ejaculations
ejaculatory	ejaculatory
eject	eject
ejectable	ejectable
ejecting	ejecting
ejection	ejection
ejector	ejector
ejectors	ejectors
elaborate	trabajado
elaborated	elaborated
elaborates	elaborates
elaborating	elaborating
elaboration	elaboration
elaborations	elaborations
elevator	ascensor
eleven	once
eleventh	eleventh
eliminate	eliminate
end	terminar/fin
environment	alrededores
envoy	embajador
envy	envidiar
envy	envidiar
escalator	escalator
establish	edificar
event	acontecimiento
eventual	eventual
eventually	eventually
ever	ever
evergreen	evergreen
everlasting	everlasting
every	cada
everywhere	en todas partes
eviction	eviction
evidence	evidence
exclaim	exclaim
fable	fable
fables	fables
fabric	tela
fabricant	fabricant
fabricate	fabricar
fabricated	fabricated
fabricates	fabricates
fabricating	fabricating
fabrication	fabrication
fabrications	fabrications
fabricator	fabricator
fabricators	fabricators
fabrics	fabrics
fabulist	fabulist
fabulous	fabulous
facade	frontón
facades	facades
faceless	faceless
faceplate	faceplate
facet	facet
facetious	facetious
facetious	facetious
facetiously	facetiously
facial	facial
facies	facies
facile	fácil
facilitate	facilitate
facilitated	facilitated
facilitates	facilitates
facilitating	facilitating
facilities	facilities
facility	facility
facing	facing
facsimile	facsimile
fact	hecho
faction	partido
factor	factor
factorial	factorial
factorials	factorials
factories	factories
factorization	factorization
factorizations	factorizations
factorize	factorize
factorized	factorized
factors	factors
factory	fábrica
facts	facts
factual	factual
facultative	facultative
facultatively	facultatively
faculties	faculties
faculty	faculty
fad	fad
fade	fade
faded	faded
fader	fader
faders	faders
fading	fading
faery	faery
faience	faience
fail	faltar
faint	débil/desmayarse
faintly	faintly
fair	bazar/pasable
fairly	fairly
fairy	fairy
faithful	faithful
faithfully	faithfully
fashionable	fashionable
fast	rápido/pronto
fastener	fastener
fastidious	fastidious
fat	grueso/gordo
fatal	fatal
fatalism	fatalism
fatality	fatality
fatally	fatally
fate	destino
fish	pez
fishable	fishable
fishbowl	fishbowl
fished	fished
fisher	fisher
fisheries	fisheries
fisherman	pescador
fishermen	fishermen
fishers	fishers
fishery	fishery
fishes	fishes
fishing	pesca
fishtail	fishtail
fission	atomización
fissionable	fissionable
fissure	fissure
fist	puño
fisted	fisted
fistful	fistful
five	cinco
fivefold	fivefold
fix	fijar/reparar
fixation	fixation
fixations	fixations
fixity	fixity
fixture	fixture
fixtures	fixtures
fjord	fjord
fjords	fjords
flight	vuelo
floppy	flexible
fluently	fluently
foot	pie
football	fútbol americano
forget	olvidar
forgetful	forgetful
forgetfulness	forgetfulness
forgivable	forgivable
forgivably	forgivably
forgive	perdonar
forgiveness	forgiveness
forgives	forgives
forgiving	forgiving
forgo	forgo
forgoes	forgoes
forgotten	forgotten
forlorn	forlorn
formaldehyde	formaldehyde
four	cuatro
fox	zorro
fractal	fractal
fractals	fractals
fraction	fraction
fractionate	fractionate
fraternal	fraternal
fraternize	fraternize
friend	amigo
friendship	amistad
fringe	fringe
frog	rana
frogs	frogs
from	de/desde
front	frontón
fucked	fucked
fudge	fudge
fugue	fugue
fulgurant	fulgurant
funk	funk
funniest	funniest
funny	cómico
gab	gab
gabardine	gabardine
gabber	gabber
gabbing	gabbing
gaberdine	gaberdine
gadget	gadget
gaiety	gaiety
gaily	gaily
gain	ganar/provecho
gained	gained
gaining	gaining
gala	gala
galactic	galactic
galaxy	galaxy
gallant	gallant
gallantly	gallantly
gallantry	gallantry
galleries	galleries
gallery	gallery
gallon	gallon
gallop	gallop
galloped	galloped
galloping	galloping
galvanic	galvanic
galvanism	galvanism
galvanize	galvanize
galvanized	galvanized
game	juego/partido
games	juegos
garlic	ajo
gas	gas
gasoline	bencina/gasolina
ghostwriter	ghostwriter
gift	regalo
gifts	regalos
go	ir/dirigirse
goal	fin/objeto
goals	goals
goat	cabra
god	dios
goddess	goddess
goddesses	goddesses
godfather	godfather
golf	golf
golfer	golfer
golfers	golfers
golfs	golfs
good	bueno
good	bueno
goodbye	adiós
goodnight	goodnight
gopher	gopher
gown	vestido
grab	asir/coger
gradient	gradient
gradually	poco a poco
grammar	gramática
grape	uva
grapefruit	pomelo
habilitated	habilitated
habilitation	habilitation
habit	costumbre/hábito
habitant	habitant
habitants	habitants
habitat	habitat
habitation	habitation
habitual	habitual
had	had
hand	trabajador/mano
head	cabeza/efigie
heats	heats
heaven	cielo
heavy	pesado
hectare	hectare
hectares	hectares
hectoliter	hectoliter
hedgehog	hedgehog
heed	acatar
heel	talón/tacón
heeler	heeler
heels	heels
height	altura/altitud
held	held
helices	helices
hell	hell
hello	hola
helm	timón/volante
helmet	casco
help	ayuda/ayudar
hemp	hemp
hen	gallina
herd	herd
here	aquí/en ésta
heron	heron
hips	hips
hit	pegar a
hockey	hockey sobre hielo
hogwash	hogwash
holidayer	holidayer
holidays	holidays
home	hogar
homeless	homeless
homes	homes
house	casa
ice	hielo
instancing	instancing
internship	internship
jab	jab
jabber	jabber
jabberwocky	jabberwocky
jabberwocky	jabberwocky
jack	gato
jackal	jackal
jackals	jackals
jackass	jackass
jackdaw	jackdaw
jacket	chaqueta
jacket	chaqueta
jackknife	jackknife
jackpot	jackpot
jade	cansar/fatigar
jaded	jaded
jag	jag
jagged	jagged
jail	prisión
jail	prisión
jailbreak	jailbreak
jailed	jailed
jailer	jailer
jailing	jailing
jailor	jailor
jails	jails
jalopy	jalopy
jam	mermelada
jam	mermelada
jamb	jamb
jammed	jammed
jammed	jammed
jangle	jangle
janitor	portero
janitor	portero
jar	jar
jar	jar
jar	jar
jargon	jargon
jasmine	jasmine
jaundice	jaundice
jaunt	jaunt
jaunty	jaunty
javelin	javelin
jaw	mandíbula
jaws	jaws
jay	jay
jazz	jazz
jazzy	jazzy
jealous	celoso
jealousy	jealousy
jeer	injuriar/insultar
jeer	injuriar/insultar
jelly	jelly
jellyfish	medusa
jeopardize	jeopardize
jeopardize	jeopardize
jerk	jerk
jerk	jerk
jerry	jerry
jersey	jersey
jersey	jersey
jest	bromear
jester	jester
jester	jester
jet	jet
jet	jet
jettison	jettison
jetty	jetty
jewel	joya
jeweler	jeweler
jewelery	jewelery
jewelry	jewelry
jewels	jewels
jib	jib
jib	jib
jiffy	jiffy
jig	jig
jigsaw	jigsaw
jihad	jihad
jilt	jilt
jingle	jingle
jingle	jingle
jingle	jingle
jinx	jinx
jitters	jitters
job	trabajo
job	trabajo
job	trabajo
jobless	jobless
jockey	jockey
jocular	jocular
jocund	jocund
jodhpur	jodhpur
jog	jog
jogging	correr
join	reunirse/juntarse
join	reunirse/juntarse
joinable	joinable
joined	joined
joiner	joiner
joinery	joinery
joint	común
joint	común
joint	común
jointly	jointly
joke	broma/chanza
joke	broma/chanza
joked	joked
joker	joker
jokingly	jokingly
jokingly	jokingly
jolly	jolly
jolt	jolt
jolt	jolt
jonquils	jonquils
jostle	jostle
jot	jot
jot	jot
journal	journal
journal	journal
journalism	journalism
journalist	periodista
journalists	journalists
journey	viaje
journey	viaje
jovial	jovial
jovially	jovially
joy	alegría
joyful	joyful
joyless	joyless
joyously	joyously
jubilee	jubilee
judge	juez/juzgar
judge	juez/juzgar
judged	judged
judgement	sentencia
judicial	judicial
judiciary	judiciary
judo	judo
jug	jarra
jug	jarra
jug	jarra
juggernaut	juggernaut
juggle	juggle
juggler	juggler
jugular	jugular
juice	jugo/zumo
juiceless	juiceless
juicier	juicier
juiciest	juiciest
juicy	jugosos
jukebox	jukebox
jumble	jumble
jumbo	jumbo
jump	saltar/salto
jumped	jumped
jumpy	jumpy
junction	unión/reunión
junction	unión/reunión
jungle	jungla
junior	junior
juniper	juniper
junk	junk
junk	junk
junk	junk
junk	junk
junkers	junkers
junkers	junkers
junkie	junkie
junkie	junkie
junkyard	junkyard
juridic	juridic
jurisdiction	jurisdiction
jurist	jurist
juror	juror
jurors	jurors
jury	jurado
just	sólo/solamente
justice	justicia
justified	justified
justify	justify
justly	justly
jut	jut
juvenile	juvenile
juxtapose	juxtapose
kale	kale
kaleidescope	kaleidescope
kaleidoscope	kaleidoscope
kangaroo	kangaroo
karat	karat
karate	karate
kayak	kayak
kebab	kebab
keel	keel
keep	vigilar/salvar
keeps	keeps
keepsake	recuerdo
keg	keg
keg	keg
kennel	kennel
kennel	kennel
kerchief	kerchief
kernel	kernel
kernel	kernel
kernel	kernel
kerosene	kerosene
ketchup	salsa de tomate
kettle	hervidor
key	llave
key	llave
key	llave
keyboard	teclado
keyhole	keyhole
keying	keying
keynote	keynote
keypad	keypad
khaki	khaki
kick	patada
kick	patada
kickback	kickback
kicked	kicked
kicker	kicker
kickoff	kickoff
kicks	kicks
kid	kid
kid	kid
kid	kid
kiddies	kiddies
kiddies	kiddies
kiddies	kiddies
kidnap	secuestrar
kidnaped	kidnaped
kidnaper	kidnaper
kidnaper	kidnaper
kidnapers	kidnapers
kidnaping	kidnaping
kidnapped	kidnapped
kidnapper	kidnapper
kidnappers	kidnappers
kidnapping	kidnapping
kidnappings	kidnappings
kidney	riñón
kidneys	kidneys
kidneys	kidneys
kids	kids
kids	kids
kill	matar
kill	matar
killer	asesino
killer	asesino
killers	killers
killing	killing
killing	killing
killings	killings
killjoy	killjoy
kiln	estufa
kilo	kilo
kilogram	kilo
kilohertz	kilohertz
kiloliter	kiloliter
kilometer	kilómetro
kilowatt	kilowatt
kilt	kilt
kin	kin
kind	amable/suerte
kind	amable/suerte
kind	amable/suerte
kindergarten	kindergarten
kindergarten	kindergarten
kindergarten	kindergarten
kindergarten	kindergarten
kindhearted	kindhearted
kindhearted	kindhearted
kindheartedness	kindheartedness
kindle	encender
kindle	encender
kindlessly	kindlessly
kindlessly	kindlessly
kindliness	kindliness
kindliness	kindliness
kindly	kindly
kindly	kindly
kindly	kindly
kindly	kindly
kindness	kindness
kindness	kindness
kindred	kindred
kindred	kindred
kinds	kinds
kinds	kinds
king	rey
kingdom	reino
kingdom	reino
kingdoms	kingdoms
kingfisher	kingfisher
kingly	kingly
kings	kings
kinky	kinky
kiosk	kiosk
kipper	kipper
kiss	beso
kiss	beso
kiss	beso
kiss	beso
kisses	kisses
kisses	kisses
kit	kit
kit	kit
kitchen	cocina
kitchenette	kitchenette
kitchens	kitchens
kitchenware	kitchenware
kitchenware	kitchenware
kite	cometa
kith	kith
kiting	kiting
kitten	kitten
kittens	kittens
kitty	kitty
kiwi	kiwi
kiwi	kiwi
kleenex	kleenex
kleenex	kleenex
kleptomania	kleptomania
kleptomaniac	kleptomaniac
knack	knack
knack	knack
knapsack	mochila
knead	knead
kneadable	kneadable
kneader	kneader
knee	rodilla
kneecap	kneecap
kneel	kneel
kneel	kneel
kneeling	kneeling
kneeling	kneeling
kneepad	kneepad
knelt	knelt
knelt	knelt
knickers	knickers
knickknack	knickknack
knickknack	knickknack
knife	cuchillo
knife	cuchillo
knifes	knifes
knifing	knifing
knight	caballo
knight	caballo
knighted	knighted
knighthood	knighthood
knightly	knightly
knights	knights
knit	knit
knit	knit
knit	knit
knitted	knitted
knitting	knitting
knitwear	knitwear
knives	knives
knob	knob
knob	knob
knobby	knobby
knobs	knobs
knock	knock
knockdown	knockdown
knockout	knockout
knot	nudo
knots	knots
knotted	knotted
knotty	knotty
know	saber
knower	knower
knowhow	knowhow
knowhow	knowhow
knowing	knowing
knowingly	knowingly
knowingly	knowingly
knowledge	conocimiento
knowledge	conocimiento
knowledgeable	knowledgeable
known	known
knows	knows
knuckle	nudillo
knuckle	nudillo
knucklebone	knucklebone
knuckles	knuckles
koala	koala
koala	koala
kosher	kosher
kraut	kraut
kraut	kraut
krauts	krauts
kudzu	kudzu
lab	lab
labor	labor
laborer	trabajador
laborer	trabajador
laborers	laborers
lace	encaje
laceration	laceration
lacerations	lacerations
lack	falta
lackadaisical	lackadaisical
lackey	lackey
lacking	lacking
lackluster	lackluster
laconic	laconic
laconically	laconically
lacquer	lacquer
lacquer	lacquer
lad	lad
ladies	damas
lady	dama
ladybird	ladybird
ladybug	ladybug
lake	lago
lakes	lakes
lamb	carne de cordero
lambs	lambs
laminated	laminated
laminates	laminates
lamp	lámpara
language	lengua/idioma
laugh	reír
leather	duro/cuero
leave	dejar/abandonar
lectern	lectern
lecture	lecture
lecturer	lecturer
ledge	ledge
ledger	ledger
lee	lee
leg	pierna
legal	legal
legality	legality
legalize	legalize
legally	legally
legate	legate
legation	legation
legend	leyende
legendary	legendary
legion	legion
letter	carta
letter	carta
letter	carta
like	aceptar/como
live	vivir
love	amar/querer/amor
love	amar/querer/amor
lover	amante/querido
luck	suerte
lunch	almuerzo/almorzar
ma	ma
ma	ma
maam	maam
maam	maam
maam	maam
macabre	macabre
macabre	macabre
macabrely	macabrely
macadam	macadam
macadam	macadam
macadamize	macadamize
macadamize	macadamize
macadamized	macadamized
macadamized	macadamized
macadamizes	macadamizes
macadamizes	macadamizes
macadamizing	macadamizing
macaque	macaque
macaque	macaque
macaroni	macarrones
macaronies	macaronies
macaroon	macaroon
macaw	macaw
mace	mace
macerate	macerate
macerated	macerated
maceration	maceration
macerations	macerations
maces	maces
machete	machete
machination	machination
machined	machined
machineries	machineries
machinery	machinery
machines	machines
machinist	machinist
machinists	machinists
machismo	machismo
macho	macho
macrocephalic	macrocephalic
macrocosm	macrocosm
macroeconomics	macroeconomics
macroevolution	macroevolution
macroevolutionary	macroevolutionary
macroinstruction	macroinstruction
macromolecular	macromolecular
macromolecule	macromolecule
macromolecules	macromolecules
macropathological	macropathological
macropathology	macropathology
macrophage	macrophage
macrophages	macrophages
macrophagic	macrophagic
macroprocessor	macroprocessor
macroscopic	macroscopic
macrosimulation	macrosimulation
macrostructure	macrostructure
maculate	maculate
maculated	maculated
maculates	maculates
maculation	maculation
maculations	maculations
mad	loco
mad	loco
madam	señora
madams	madams
maddened	maddened
made	made
made	made
mademoiselle	mademoiselle
mademoiselles	mademoiselles
maestro	maestro
mafioso	mafioso
magazine	periódico/revista
magic	magic
magician	mago
magicians	magicians
magistral	magistral
magistrally	magistrally
magistrature	magistrature
magma	magma
me	yo
mead	mead
meadow	prado
meadow	prado
meadowland	meadowland
meadows	meadows
meager	miserable/pobre
meagerly	meagerly
meagre	meagre
meal	harina/comida
meals	meals
mean	significar
meander	meander
meaningless	meaningless
meanings	meanings
means	instrumento/medio
meat	carne
meats	meats
meatball	meatball
meatballs	meatballs
mechanical	mechanical
mechanician	mechanician
mechanism	mechanism
mechanisms	mechanisms
medal	medal
medallion	medallion
medallions	medallions
mediatrice	mediatrice
mediatrix	mediatrix
medic	medic
medical	medical
medically	medically
medicament	medicament
medicaments	medicaments
medicinal	medicinal
medicine	medicina
medicines	medicines
medico	medico
medicolegal	medicolegal
medics	medics
medieval	medieval
medievalist	medievalist
medievalists	medievalists
mediocre	mediocre
mediocrity	mediocrity
meditate	meditate
meditates	meditates
meditation	meditation
meditations	meditations
meditative	meditative
medium	mediano
medlar	medlar
medley	medley
medleys	medleys
medulla	medulla
medusae	medusae
meek	meek
meekly	meekly
meekness	meekness
meerschaum	meerschaum
megabyte	megabyte
megabytes	megabytes
megacycle	megacycle
megahertz	megahercio
megalith	megalith
megalithic	megalithic
megalomania	megalomania
megalomaniac	megalomaniac
megalomaniacal	megalomaniacal
megaphone	megaphone
melancholia	melancholia
melancholic	melancholic
melange	melange
melodic	melodic
melodies	melodies
melodious	melodious
melodrama	melodrama
melodramas	melodramas
melodramatic	melodramatic
melody	melody
melon	melón
melons	melons
melted	melted
member	miembro
members	members
membrane	membrane
membranes	membranes
membranous	membranous
memoir	memoir
memoirs	memoirs
memorable	memorable
memories	memories
memorize	memorize
memorized	memorized
men	caballeros
menace	amenaza
menagerie	menagerie
menageries	menageries
menhir	menhir
meningitis	meningitis
meniscus	meniscus
menopause	menopause
menstrual	menstrual
menstruation	menstruation
menstruations	menstruations
mental	mental
mentality	mentality
menthol	menthol
mention	mencionar
menu	menú/lista
meow	meow
meowing	meowing
meows	meows
mephitic	mephitic
mercantile	mercantile
mercantilism	mercantilism
mercenaries	mercenaries
mercenary	mercenary
merchant	comerciante
merchants	merchants
mercury	mercury
mercy	misericordia
meridian	meridian
meridional	meridional
merit	merit
meritocracy	meritocracy
merits	merits
mermaid	sirena
mermaids	mermaids
merry	merry
message	mensaje
messages	mensajes
messiahs	messiahs
messianic	messianic
moan	moan
moaned	moaned
moaning	moaning
moans	moans
moat	moat
moats	moats
mob	mob
mock	mock
mocked	mocked
mockery	mockery
modal	modal
moonlight	moonlight
moose	moose
naive	naive
naively	naively
naked	desnudo
name	nombre
named	named
nameless	anónimo
namely	namely
namely	namely
names	names
national	nacional
nationalism	nationalism
nationalist	nationalist
native	innato/indígena
natural	fine
naturalize	naturalize
naturally	naturalmente
neap	neap
nearby	próximo/cerca
nearer	nearer
neglect	neglect
neighbor	vecino
neighbors	vecinos
network	red
networked	networked
networks	networks
nine	nueve
nineteen	diez y nueve
nineteenth	nineteenth
nineties	nineties
ninetieth	ninetieth
ninety	noventa
ninetyfold	ninetyfold
ninth	ninth
niobium	niobium
nip	aperitivo
nipple	nipple
nipples	nipples
nips	nips
nirvana	nirvana
nitrate	nitrate
nitrated	nitrated
nitrates	nitrates
nitrating	nitrating
nitration	nitration
nitrations	nitrations
nitric	nitric
nitride	nitride
nitrogen	nitrogen
nitroglycerin	nitroglycerin
nitroglycerine	nitroglycerine
noble	level
nobleman	nobleman
noblemen	noblemen
nobleness	nobleness
nobody	nadie/ninguno
noctambulism	noctambulism
noctambulist	noctambulist
nocturn	nocturn
nocturnally	nocturnally
now	actualmente/ahora
nowadays	hoy en día
noway	noway
noway	noway
oaf	oaf
oafishness	oafishness
oak	roble
oar	remo
oarsman	remero
oasis	oasis
oat	oat
oath	oath
oatmeal	oatmeal
obdurate	obdurate
obedience	obedience
obedient	obedient
obelisk	obelisk
obese	obese
obesity	obesity
ocean	océano
one	uno
orange	naranja
oranges	oranges
orbit	orbit
orbital	orbital
orbits	orbits
orchestra	orquestra
orchestral	orchestral
orchestras	orchestras
orchestrated	orchestrated
order	pedir/pedido/orden
ordered	ordered
organism	organism
organisms	organisms
organist	organist
organists	organists
organization	organization
organizations	organizations
organize	organize
organized	organized
organs	organs
orgasm	orgasmo
orgasms	orgasms
orgies	orgies
orgy	orgia
orient	orient
orientable	orientable
orientation	orientation
orientations	orientations
oriented	oriented
orients	orients
orifice	orifice
orifices	orifices
orificial	orificial
origin	descendencia/origen
original	original
originality	originality
originally	originally
originals	originals
origins	origins
ornamental	ornamental
ornithology	ornithology
orthodox	orthodox
orthodoxes	orthodoxes
orthogonal	orthogonal
pace	paso
pace	paso
pachyderm	pachyderm
pacific	pacífico
pacifically	pacifically
pacification	pacification
pacifications	pacifications
pacificist	pacificist
pacifier	pacifier
pacifism	pacifism
pacifist	pacifist
pacify	pacify
pacify	pacify
package	paquete
package	paquete
packaged	packaged
packaged	packaged
packed	packed
packet	paquete
packing	packing
pact	pact
pacts	pacts
pad	bloque
padding	padding
paddle	paddle
paddock	paddock
padlock	padlock
padlock	padlock
padrone	padrone
paella	paella
pagan	pagan
pagans	pagans
pageant	pageant
pageantry	pageantry
paid	paid
pail	cubo
pain	dolor
pained	pained
painful	painful
painful	painful
painfully	painfully
painstaking	painstaking
paint	pintura/pintar
paint	pintura/pintar
paintbrush	pincel
painter	pintor
painters	painters
painting	cuadro/pintura
paints	paints
pair	par
pajamas	pijama
pal	pal
pal	pal
palace	palacio
palatable	palatable
palaver	palaver
pale	pálido
palette	paleta
pall	pall
pallet	pallet
pallette	pallette
pallor	pallor
palm	palmera
palm	palmera
palpable	palpable
palpable	palpable
paltry	paltry
pamphlet	folleto
pan	cacerola
panacea	panacea
panama	panamá
pancake	pancake
panda	oso panda
pandemonium	pandemonium
pane	pane
panel	panel
paneling	paneling
panelling	panelling
pang	pang
panic	panic
panic	panic
panicky	panicky
panorama	panorama
pansy	pansy
pant	pant
panther	panther
panties	calzoncillos
pantry	despensa
pants	pantalones
papa	papa
paper	documento/papel
paperback	folleto
parameter	parameter
passer	passer
passion	passion
passionately	passionately
passive	passive
passivity	passivity
password	password
passwords	passwords
past	pasado
pasta	pasta
pectorals	pectorals
peculiar	peculiar
penitence	penitence
penitences	penitences
penitency	penitency
penitent	penitent
pentadactyl	pentadactyl
pentadactylism	pentadactylism
pi	pi
pianist	pianist
pianistic	pianistic
picture	imagen/pintura
pictures	pictures
pie	pastel/torta
pies	pies
pig	cerdo
pigeonhole	pigeonhole
pigment	pigment
pigmentation	pigmentation
pigments	pigments
pigs	pigs
pilot	piloto
pilots	pilots
pilule	pilule
pine	pino
pineapple	ananás/piña
pineapples	pineapples
pines	pines
pink	rosado
pocket	bolsillo
pocketbook	pocketbook
pocketbooks	pocketbooks
pockets	pockets
podium	podium
pogrom	pogrom
pogroms	pogroms
pointer	pointer
pointillism	pointillism
pointillist	pointillist
pointilliste	pointilliste
pointillistic	pointillistic
poison	veneno
poisonous	tóxico
poisonousness	poisonousness
poisons	poisons
polar	polar
polarities	polarities
polarity	polarity
polarize	polarize
polarized	polarized
polemical	polemical
polemically	polemically
polemicize	polemicize
police	policía
policeman	guardia
policeman	guardia
policeman	guardia
policemen	policemen
policemen	policemen
policemen	policemen
policewoman	policewoman
policewomen	policewomen
policy	póliza/política
polish	polaco/polonés
polish	polaco/polonés
polite	cortés
politely	politely
politeness	cortesía
political	political
politically	politically
politician	político/hombre político
politicians	politicians
politics	política
polka	polka
pollutant	pollutant
pollute	pollute
polluted	polluted
polluter	polluter
pollution	contaminacion
polonium	polonium
poltergeist	poltergeist
polyandrous	polyandrous
polyandry	polyandry
pour	verter
pout	pout
poverty	pobreza
powder	polvos
powdery	powdery
power	potencia
powerful	powerful
powerless	powerless
powwow	powwow
practicability	practicability
practicable	practicable/transitable
practical	practical
pray	rezar
prayer	oracion
prayers	prayers
praying	praying
praying	praying
preach	preach
preach	preach
preacher	preacher
preacher	preacher
preachers	preachers
preachers	preachers
preaches	preaches
preaches	preaches
preachify	preachify
preaching	preaching
preaching	preaching
preaching	preaching
preachy	preachy
preachy	preachy
preamplifiers	preamplifiers
prearrange	prearrange
prearrange	prearrange
prince	príncipe
princedom	princedom
princely	princely
princes	princes
princess	princesa
principal	principal
principal	principal
principalities	principalities
principality	principality
principally	principalmente
principally	principalmente
principals	principals
principle	principio
principles	principles
print	imprimir/copiar
print	imprimir/copiar
print	imprimir/copiar
printed	printed
printer	impresora
printer	impresora
priorities	priorities
priorities	priorities
priority	priority
prove	probar
pulse	pulso
pulverizable	pulverizable
pulverizables	pulverizables
pulverization	pulverization
pulverize	pulverize
pulverized	pulverized
pulverizer	pulverizer
pulverizers	pulverizers
pulverizes	pulverizes
pulverizing	pulverizing
puma	puma
pump	bomba
push	empujar
pushchair	pushchair
pushing	pushing
put	meter/poner
putdown	putdown
putout	putout
putrefaction	putrefaction
quail	quail
quails	quails
quake	quake
quality	calidad/ralea
qualm	qualm
qualms	qualms
quantity	cantidad
quarrel	quarrel
quarry	quarry
quarter	barrio
quarterdeck	quarterdeck
quarterfinal	quarterfinal
queen	reina
queer	queer
quell	quell
quench	quench
querulous	querulous
query	query
quest	quest
question	pregunta
queue	queue
quibble	quibble
quick	rápido
quicklime	quicklime
quickly	pronto
quicksand	arenas movedizas
quicksilver	quicksilver
quiet	quieto/silencio
quieten	quieten
quietly	quietly
quill	quill
quilt	quilt
quirk	quirk
quit	dimitir
quite	muy
quota	prorrata
quotation	cita/citación
quote	citar/anotar
r	r
rabbet	rabbet
rabbi	rabi
rabbinic	rabbinic
rabbit	conejo
rabbits	rabbits
rabble	rabble
rabid	rabid
rabies	rabies
raccoon	raccoon
race	correr/raza
racehorse	racehorse
racemic	racemic
racer	racer
races	races
rachis	rachis
rachitic	rachitic
rachitis	rachitis
racialism	racialism
racialist	racialist
racialistic	racialistic
racing	racing
racism	racism
racist	racist
rack	rack
racket	raqueta
racket	raqueta
radar	radar
radars	radars
radio	radio
read	leer
readability	readability
readable	readable
reader	reader
readers	readers
readership	readership
readership	readership
readily	readily
readily	readily
readily	readily
readiness	readiness
readiness	readiness
reading	reading
reading	reading
reading	reading
readings	readings
readings	readings
readjust	readjust
readjusts	readjusts
readjusts	readjusts
readout	readout
readout	readout
readouts	readouts
reads	reads
ready	listo
ready	listo
ready	listo
reaffirm	reaffirm
reaffirm	reaffirm
reaffirms	reaffirms
reaffirms	reaffirms
reagent	reagent
real	real
real	real
real	real
realisable	realisable
realism	realism
realist	realist
realistic	realistic
realistic	realistic
realistically	realistically
reality	verdad
realize	comprender/entender
really	en efecto/realmente
reporter	reportero
represent	reproducir/retratar
request	demanda
request	demanda
request	demanda
road	carretera/ruta
roads	roads
roadwork	roadwork
robber	robber
rotting	rotting
sabbat	sabbat
sabbath	sabbath
sabbatic	sabbatic
sabbatical	sabbatical
saber	saber
sabin	sabin
sable	sable
sabot	sabot
sabotage	sabotage
sabotaged	sabotaged
sabotages	sabotages
saboteur	saboteur
sabra	sabra
sabras	sabras
saccade	saccade
saccharin	saccharin
saccharine	saccharine
saccharose	saccharose
sacerdotal	sacerdotal
sacerdotally	sacerdotally
sachet	sachet
sack	despedir/bolso
sack	despedir/bolso
sackcloth	sackcloth
sacked	sacked
sackful	sackful
sacks	sacks
sacrament	sacrament
sacramental	sacramental
sacraments	sacraments
sacre	sacre
sacred	sacred
sacrifice	ofrecer/presentar
sacrificed	sacrificed
sacrifices	sacrifices
sacrilege	sacrilege
sad	triste
sadden	acongojar
sadder	sadder
saddest	saddest
saddle	saddle
saddlebag	saddlebag
saddlebags	saddlebags
saddlebow	saddlebow
saddlecloth	saddlecloth
saddled	saddled
saddleless	saddleless
saddler	saddler
saddlery	saddlery
saddles	saddles
saddletree	saddletree
sadism	sadism
sadist	sadist
sadistic	sadistic
sadistically	sadistically
sadists	sadists
sadly	sadly
sadness	tristeza
safari	safari
safe	seguro
safecracker	safecracker
safecracking	safecracking
safeguard	safeguard
safeguarded	safeguarded
safeguards	safeguards
safer	safer
safest	safest
safety	seguridad
safflower	safflower
saffron	saffron
sag	sag
saga	saga
sagacious	sagacious
sagaciously	sagaciously
sagaciousness	sagaciousness
sagacity	sagacity
sage	salvia
sagely	sagely
sago	sago
saguaro	saguaro
sahib	sahib
said	said
sail	sail
sail	sail
sailable	sailable
sailboat	bote de vela
sailboater	sailboater
sailcloth	sailcloth
sailors	sailors
sails	sails
sainfoin	sainfoin
saint	santa/santo
sainted	sainted
sainthood	sainthood
saith	saith
sake	sake
salability	salability
salacious	salacious
salad	ensalada
salads	salads
salamander	salamandra
salaried	salaried
salaries	salaries
sale	venta
saleable	saleable
saleroom	saleroom
salesclerk	salesclerk
salesgirl	salesgirl
saleslady	saleslady
salesman	vendedor
salesmanship	salesmanship
salesmen	salesmen
salespeople	salespeople
salesperson	salesperson
salesroom	salesroom
saleswoman	vendedora
saleswomen	saleswomen
salient	salient
saline	saline
salinity	salinity
salinometer	salinometer
salinometers	salinometers
saliva	saliva
salivary	salivary
salivate	salivate
salivated	salivated
salivates	salivates
salivating	salivating
salivation	salivation
sallies	sallies
sallow	pálido
sallowish	sallowish
salmon	salmón
salmons	salmons
salon	salon
salons	salons
salt	sal
saltwater	saltwater
saltworks	saltworks
saltwort	saltwort
salty	salty
salubrious	salubrious
salubrity	salubrity
salvage	salvage
salver	salver
samba	samba
same	misma
sampan	sampan
samphire	samphire
samurai	samurai
samurais	samurais
sand	arena
sandal	sandalia
school	escuela
sea	36586
sell	vender
seller	seller
sellers	sellers
serendipity	serendipity
serene	serene
seven	siete
sevenfold	sevenfold
seventeen	diez y siete
seventeenth	seventeenth
seventh	seventh
seventies	seventies
seventieth	seventieth
seventy	setenta
seventyfold	seventyfold
sever	sever
severe	áspero/inclemente
severed	severed
severely	severely
severities	severities
severity	severity
sewage	sewage
sex	sexo
sexagenarian	sexagenarian
sexual	sexual
sexually	sexually
shades	shades
shadow	sombra
shadows	shadows
shagreen	shagreen
shah	shah
shake	agitar
shakedown	shakedown
shaken	shaken
shaky	shaky
shaman	shaman
shamanism	shamanism
shampoo	champú
shampoos	shampoos
sheep	oveja
sheepherder	sheepherder
ship	expedir/barco
ship	expedir/barco
shit	mierda
sick	enfermo
silver	plata
sing	cantar
singer	cantora
sink	bucear
six	seis
sixteen	diez y seis
sixteenth	sixteenth
sixties	sixties
sixty	sesenta
sixtyfold	sixtyfold
size	tamaño
skate	patinar
skateboard	skateboard
skateboarder	skateboarder
skateboarding	skateboarding
skateboards	skateboards
skater	skater
skaters	skaters
skates	skates
skating	skating
skill	skill
skilled	experto/hábil
skilless	skilless
skillful	experto/hábil
sky	cielo
skylark	skylark
skyscraper	skyscraper
snout	snout
snow	nieve
snowball	snowball
snowflake	copo de nieve
snowman	snowman
snowstorm	snowstorm
software	software
sorrily	sorrily
sorrow	tristeza
sort	suerte
sorted	sorted
sorter	sorter
soul	alma
spectra	spectra
spectrum	spectrum
speculate	speculate
speculation	speculation
staple	grapa
stapled	stapled
stapler	engrapador
staplers	staplers
staples	staples
star	estrella
stars	stars
start	salida/salir
stifled	stifled
strength	fuerza
stupid	zote
subject	asignatura
succeed	conseguir
success	acierto
sun	sol
sunbathe	sunbathe
sunny	sunny
suppressed	suppressed
suspect	suspect
swear	swear
tab	tab
tab	tab
tabernacle	tabernacle
table	mesa/tabla
tableau	tableau
tableaus	tableaus
tableaux	tableaux
tablecloth	mantel
tablecloths	tablecloths
tables	tablas
tablet	pastilla
tablets	tablets
taboos	taboos
tachometer	tachometer
tachometers	tachometers
tacit	tacit
tail	cola
tailor	costurera/sastre
tailored	tailored
tailors	tailors
tails	tails
task	task
tasks	tasks
taste	gusto/saborear
tasted	tasted
tasteless	soso
tear	lágrima
tear	lágrima
tear	lágrima
tear	lágrima
teardrop	teardrop
tearful	tearful
tearfully	tearfully
tearfully	tearfully
teargas	teargas
tearjerker	tearjerker
tearless	tearless
tearless	tearless
tearoom	tearoom
tears	tears
tears	tears
tearstained	tearstained
tearstained	tearstained
tease	zumbon
tease	zumbon
tease	zumbon
teasel	teasel
teaser	teaser
teaser	teaser
teases	teases
teases	teases
teases	teases
teasing	teasing
teasing	teasing
teasingly	teasingly
teasingly	teasingly
teaspoon	cucharita
teaspoon	cucharita
teaspoonful	cucharadita
teat	teat
teat	teat
teat	teat
teat	teat
teatime	teatime
teats	teats
teats	teats
ten	diez
tendencies	tendencies
tendency	tentación
tenderfoot	tenderfoot
tenderly	tenderly
thence	thence
thence	thence
thenceforth	thenceforth
thenceforward	thenceforward
theocracy	theocracy
theocratic	theocratic
theodolite	theodolite
theologian	theologian
theologians	theologians
theological	theological
theologically	theologically
theology	theology
theorem	theorem
theorems	theorems
theoretical	theoretical
theoretical	theoretical
theoretically	theoretically
theoretician	theoretician
theoretician	theoretician
theoreticians	theoreticians
theoreticians	theoreticians
theorist	theorist
theorist	theorist
theorists	theorists
theorists	theorists
theorize	theorize
thief	ladrón
though	aunque
though	aunque
thought	pensamiento
thought	pensamiento
thoughtful	circunspecto/prudente
thoughtfully	thoughtfully
thoughtfulness	thoughtfulness
thoughtless	thoughtless
thoughtlessly	thoughtlessly
thoughtlessness	thoughtlessness
thousand	mil
thousandth	thousandth
thrash	aporrear
thrash	aporrear
thread	hilo
thread	hilo
thread	hilo
threadbare	threadbare
threat	amenaza/conminación
threaten	amenazar/conminar
threatening	threatening
threateningly	threateningly
three	tres
tigress	tigress
today	hoy
toe	dedo de pie
tradition	tradicion
traditional	traditional
trail	trail
train	adiestrar/tren
trainee	trainee
trainer	trainer
traitor	traitor
transaction	transaction
transalpine	transalpine
transcribe	transcribir
transfer	atravesar
translate	traducir
translation	traducción
translator	translator
transmit	despachar
tree	árbol
truck	camión
two	dos
ubiquitous	ubiquitous
ubiquity	ubiquity
udder	udder
ugh	ugh
uglier	uglier
ugliest	ugliest
uglify	uglify
uglily	uglily
ugliness	ugliness
ugly	feo
ukulele	ukulele
ulcer	úlcera
ulcerate	ulcerate
ulcerated	ulcerated
ulceration	ulceration
ulcerative	ulcerative
ulna	ulna
ultimo	ultimo
unemployment	unemployment
vacant	vacant
vacate	vacate
vacation	vacaciones
vaccinate	vacunar
vaccinated	vaccinated
vacuum	aspirador
vacuumed	vacuumed
vagina	vagina
vagrant	vagrant
vague	vague
vain	vanidoso
wacky	wacky
wag	wag
walnut	walnut
warehouse	warehouse
warehouse	warehouse
warehouses	warehouses
wash	lavar
weep	llorar
weeping	weeping
weeping	weeping
weeps	weeps
weepy	weepy
weepy	weepy
weevil	weevil
weft	weft
weigh	pesar
weigh	pesar
weighing	weighing
weighings	weighings
weighs	weighs
weight	peso
weighted	weighted
weighted	weighted
weightily	weightily
weighting	weighting
weighting	weighting
weightless	weightless
weightlessness	weightlessness
weights	weights
weights	weights
weighty	weighty
weighty	weighty
weir	weir
weird	weird
weirdie	weirdie
weirdies	weirdies
weirdly	weirdly
weirdness	weirdness
weirdness	weirdness
weirdo	weirdo
weirdos	weirdos
weirs	weirs
welcome	bienvenido
welcome	bienvenido
welcome	bienvenido
welcome	bienvenido
where	adonde
window	ventana/taquilla
window	ventana/taquilla
windowpane	windowpane
windowpanes	windowpanes
windows	windows
windstorm	windstorm
wine	vino
wineglass	wineglass
winegrower	winegrower
winemaker	winemaker
winemaking	winemaking
winepress	winepress
wines	wines
winey	winey
wing	ala
winglet	winglet
wink	wink
winter	invierno
wipe	enjugar/limpiar
wire	alambre
wire	alambre
wire	alambre
wired	wired
wireless	radio
wiring	wiring
wiry	wiry
wisdom	sabiduria
wise	sabio
wisecrack	wisecrack
wisely	wisely
wiser	wiser
wish	desear/deseo
wish	desear/deseo
wishbone	wishbone
wishes	wishes
wishful	wishful
witch	witch
witches	witches
with	con
withdraw	retirar
withdraw	retirar
without	sin
witness	testigo
witness	testigo
witnesses	witnesses
wolverine	wolverine
wolverine	wolverine
world	mundo
worldwide	worldwide
xenophobe	xenophobe
xenophobia	xenophobia
xenophobic	xenophobic
xerographic	xerographic
xylem	xylem
xylene	xylene
xylophone	xylophone
xylophones	xylophones
xylophonist	xylophonist
xylose	xylose
xylotomic	xylotomic
yacht	yate
yachting	yachting
yachtsman	yachtsman
yak	yak
yam	yam
yap	yap
yard	grave/patio
yardstick	yardstick
yarn	yarn
yawn	bostezar
yawn	bostezar
yawning	yawning
yeah	yeah
year	año
yearbook	yearbook
yearlong	yearlong
yearly	anualmente
yearly	anualmente
yearn	yearn
yearning	yearning
yearningly	yearningly
years	anos
yeast	yeast
yell	yell
yell	yell
yellow	amarillo
yellowed	yellowed
yellowing	yellowing
yellowish	yellowish
yes	sí
yesterday	ayer
yet	aún/todavia
yew	yew
yield	abandonar/ceder
yoga	yoga
yoghurt	yogur
yogurt	yogur
yoke	yugo
yolk	yolk
you	tú/usted
you	tú/usted
young	joven
younger	younger
youngster	joven
youth	juventud/joven
youthful	youthful
yuppie	yuppie
zabaglione	zabaglione
zany	zany
zazen	zazen
zeal	celo
zealous	zealous
zebra	cebra
zenith	zenith
zero	cero
zero	cero
zest	zest
zigzag	zigzag
zinc	zinc
zipper	cremallera
zodiac	zodiaco
zodiac	zodiaco
zone	zona
zone	zona
zoo	jardín zoológico
zoology	zoologia
zoom	zoom
zucchini	calabacín
