à	ein
à	ein
aardvark	aardvark
aardvark	aardvark
aardvarks	aardvarks
aback	zurück
aback	zurück
aback	zurück
abacterial	abacterial
abaque	abacus
abaque	abacus
abaque	abacus
abacuses	abacuses
abacuses	abacuses
abacuses	abacuses
abaft	abaft
abalone	abalone
abalones	abalones
abandonner	ablassen
abandonner	ablassen
immoral	impertinent
immoral	impertinent
immoral	impertinent
abandonee	abandonee
abandoner	abandoner
abandoning	abandoning
abandonment	zession
abandonment	zession
abandonments	abandonments
humilier	demütigen
abased	abased
abasement	abasement
abasements	abasements
abases	abases
abash	beschämen
abashed	verlegen
abashed	verlegen
abasing	abasing
diminuer	erschlaffen
diminuer	erschlaffen
abated	abated
rabais	nachlaß
rabais	nachlaß
abatements	abatements
abates	abates
abating	abating
abating	abating
boucherie	abattoir
abbe	abbe
abberations	abberations
abbaye	abtei
abbaye	abtei
abbeys	abbeys
abbé	abt
abbé	abt
abbé	abt
abbé	abt
abbé	abt
abbots	abbots
raccourcir	abkürzen
raccourcir	abkürzen
abbreviated	abbreviated
abbreviates	abbreviates
abbreviating	abbreviating
abbreviation	verkürzung
abbreviation	verkürzung
abbreviation	verkürzung
abbreviations	verkürzungen
abbreviations	verkürzungen
abbreviator	abbreviator
abdicable	abdicable
abdiquer	abdanken
abdiquer	abdanken
abdicated	abdicated
abdication	abdication
abdicator	abdicator
abdomen	hinterleib
abdomen	hinterleib
abdomens	abdomens
abdominal	den unterbauch betreffend
abdominally	abdominally
abduct	abduct
abducted	abducted
abducting	abducting
abduction	abduction
abductions	abductions
abducteur	abductor
abductors	abductors
abeam	quer
abecedarian	abecedarian
abed	abed
aberrance	abweichung
aberrant	aberrant
aberrantly	aberrantly
erreur	aberration
erreur	aberration
aberrations	aberrations
agiter	agitieren
abetment	mithilfe
abets	abets
abetted	abetted
abetter	abetter
abetting	abetting
abettor	abettor
abeyance	ruhen
abeyant	abeyant
abominer	verabscheuen
abhorred	abhorred
abomination	abscheu
abominable	abhorrent
abhorrently	abhorrently
abhorring	abhorring
abhors	abhors
attendre	gewärtigen
abided	abided
abides	abides
permanent	fest
abilities	abilities
capacité	kapazität
capacité	kapazität
abiotic	abiotic
lâche	gemein
abjection	abjection
abjectly	abjectly
abjuration	abjuration
abjurer	annullieren
abjurer	abjurer
ablation	ablation
ablatif	ablativ
ardant	ablaze
ardant	ablaze
apte à	begabt
apte à	begabt
apte à	begabt
apte à	begabt
abler	abler
ablest	ablest
abloom	abloom
ablution	ablution
ablutions	ablutions
ably	ably
agir avec abnégation	abnegate
abnegates	abnegates
abnegation	aufopferung
abnormal	abnormal
abnormal	abnormal
abnormal	abnormal
abnormalities	abnormalities
abnormality	abnormalität
abnormally	abnormally
aboard	an bord
domicile	wohnort
abodes	abodes
aboil	aboil
abolir	annullieren
abolir	annullieren
abolishable	abolishable
abolished	abolished
abolisher	abolisher
abolishes	abolishes
abolishment	abolishment
abolition	abolition
abolition	abolition
abolitionism	abolitionism
abolitionist	abolitionist
abolitionists	abolitionists
abominable	abscheulich
abominably	abominably
abominer	verabscheuen
abomination	abscheu
abominations	abominations
aborigène	eingeboren
aboriginally	aboriginally
aborigine	aborigine
aborigines	aborigines
avorter	abortieren
aborted	aborted
aborter	aborter
aborting	aborting
avortement	fiasko
avortement	fiasko
avorteur	abortionist
abortionists	abortionists
abortions	abortions
inutile	nutzlos
abortively	abortively
aborts	aborts
abonder	schwärmen
concernant	betreffs
au-dessus de	oberhalb
aboveboard	aboveboard
aboveground	aboveground
abovementioned	abovementioned
abovementioned	abovementioned
abracadabra	abracadabra
abradable	abradable
abrade	hobeln
abrasion	abrasion
abrasions	abrasions
acéré	grell
abrasives	abrasives
abreast	abreast
limiter	begrenzen
abridged	abridged
réduction de texte	übersicht
abridging	abridging
à l'étranger	äußerlich
abolir	annullieren
abrogated	abrogated
abolition	abrogation
abrupt	abgerissen
abruptement	abruptly
abruptness	abruptness
abcès	abszeß
abscesses	abscesses
s'enfuir	ausreißen
absconded	absconded
absence	abwesenheit
absences	absences
absent	abwesend
absentee	abwesend
absenteeism	absenteeism
absentees	absentees
absently	abwesend
absentminded	absentminded
absentmindedly	absentmindedly
absentmindedly	absentmindedly
absentmindedness	absentmindedness
absinthe	beifuß
absinthe	beifuß
absolu	absolut
absolument	freilich
absolution	begnadigung
absolutisme	absolutismus
absoudre	absolvieren
absolved	absolved
absolving	absolving
absorber	absorbieren
absorbability	absorbability
absorbable	absorbable
absorbant	absorbant
absorbed	absorbed
absorbant	absorbent
absorbing	absorbing
absorption	absorption
faire abstinence	abstain
abstained	abstained
sobre	abstinent
abstention	abstinenz
abstentions	abstentions
abstinence	abstinenz
abstinent	abstinent
abstinently	abstinently
abstrait	abstrakt
abstrait	abstrakt
abstraction	diebstahl
mystérieux	geheimnissvoll
absurde	abgeschmackt
absurdism	absurdism
absurdist	absurdist
absurdities	absurdities
absurdité	verdrehtheit
abondance	reichtum
abondant	reichlich
abondamment	im überfluß
insulter	beleidigen
abused	abused
abusive	anzüglich
abusively	abusively
abut	abut
abuzz	abuzz
terrible	unerforschlich
abysmally	abysmally
abîme	abgrund
abîme	abgrund
abysses	abysses
abysses	abysses
acacia	akazie
académique	student
academical	academical
academically	academically
académicien	academician
academies	academies
academism	academism
académie	akademie
acanthe	akanthus
acanthuses	acanthuses
adhérer	beipflichten
adhérer	beipflichten
accélerer	beeilen
accelerated	accelerated
accélération	acceleration
accelerations	accelerations
accélérateur	accelerator
accelerators	accelerators
accelerometer	accelerometer
accelerometers	accelerometers
accentuer	accent
accented	betonte
accented	betonte
accents	accents
accentual	accentual
accentually	accentually
accentuer	betonen
accentuated	accentuated
accentuation	accentuation
accepter	annehmen
acceptability	acceptability
acceptable	acceptable
acceptably	acceptably
accueil	annahme
accepté	accepted
accepter	accepter
accepteur	acceptor
accès	anfall
accessed	accessed
accessibility	accessibility
sensible	zugänglich
acquisition	errungenschaft
accessorial	accessorial
accessories	zubehör
accessorize	accessorize
accessors	accessors
accessoire	accessory
accident	unfall
accidental	zufällig
accidentalism	accidentalism
accidentalist	accidentalist
accidentally	accidentally
accidently	accidently
accidents	accidents
acclamer	akklamieren
acclamation	beifall
acclimate	acclimate
acclimated	acclimated
acclimatize	akklimatisieren
accolade	accolade
accolades	accolades
adapter	adaptieren
accommodated	accommodated
accommodating	entgegenkommend
accomodation	einrichtung
accommodations	accommodations
accompanied	accompanied
accompanier	accompanier
accompanies	accompanies
accompagnement	geleit
accompaniments	accompaniments
cavalier	gefährte
accompanists	accompanists
accompagner	begleiten
accompanyist	accompanyist
accompanyists	accompanyists
accomplice	accomplice
accomplices	accomplices
atteindre	erlangen
accomplished	accomplished
accomplishment	accomplishment
accomplishments	accomplishments
accord	akkord
accordance	accordance
accorder	accorder
accorders	accorders
accordéon	ziehharmonika
accordéoniste	accordionist
accordionists	accordionists
accordions	accordions
accords	accords
accost	ansprechen
compte	konto
accountability	accountability
accountable	accountable
accountant	buchrevisor
accounting	buchführung
accouterment	accouterment
accrued	accrued
accruement	accruement
accumulated	accumulated
acetaminophen	acetaminophen
acetify	acetify
acetone	acetone
acide	herb
acidic	acidic
allergen	allergen
allergen	allergen
allergic	allergic
allergies	allergies
allergies	allergies
allergy	allergie
allergy	allergie
alleviate	alleviate
alleviated	alleviated
ruelle	gasse
ruelle	gasse
alleys	alleys
alleys	alleys
alliance	verbindlichkeit
alliance	verbindlichkeit
alliances	alliances
alliances	alliances
allied	allied
allied	allied
alligator	alligator
alligator	alligator
alligators	alligators
alligators	alligators
alliteration	alliteration
alliteration	alliteration
alliterations	alliterations
alliterations	alliterations
allocate	allocate
allocated	allocated
allocation	allocation
allocation	allocation
allocations	allocations
allocution	allocution
allocution	allocution
allocution	allocution
allot	verlosen
laisser	lassen
allowable	zulässig
allowance	erlaubnis
allowed	erlaubt
alliage	legierung
alphabet	alphabet
alphabetic	alphabetic
alphabetical	alphabetical
alphabetization	alphabetization
alphabetizations	alphabetizations
alphabetize	alphabetize
alphabetized	alphabetized
alphabetizing	alphabetizing
alphabets	alphabets
alphamerical	alphamerical
alphanumeric	alphanumerisch
alphanumerical	alphanumerical
alphanumerically	alphanumerically
alphanumerics	alphanumerics
alpine	alpine
alpinism	alpinism
alpinist	alpinist
déjà	bereits
aussi	auch
altercation	altercation
altercations	altercations
alterner	sich ablösen
alternated	alternated
alternately	alternately
entre	unter
amoral	amoral
amorous	amorous
amorously	amorously
amorphous	amorph
nombre	anzahl
nombre	anzahl
amp	amp
ampere	ampère
ampersand	ampersand
amphetamine	amphetamine
et	und
anyway	anyway
quelque part	irgendwo
aorta	aorta
apace	schnell
particulier	abgesondert
apartheid	apartheid
appartement	appartement
apathetic	indolent
apathie	apathie
singe	affe
singe	affe
aperitif	aperitif
orifice	öffnung
apex	spitze
aphid	aphid
arriver	eintreffen
aspen	espe
vérifier	kontrollieren
auditorium	auditorium
auditoriums	auditoriums
audits	audits
available	verfügbar
babble	quasseln
babbler	babbler
babies	babies
babouin	pavian
bébé	kinder
baccalaureate	baccalaureate
baccarat	baccarat
célibataire	hagestolz
bachelors	bachelors
bacilli	bacilli
bacillus	bacillus
dos	rücken
backache	backache
backbite	backbite
backbone	wirbelsäule
arrière-plan	hintergrund
backgrounds	backgrounds
derrière	after
backslide	backslide
backup	backup
backward	backward
lard	speck
bacteria	bakterien
mal	böse
insigne	insignien
badged	badged
badgers	badgers
badinage	badinage
bag	beutel
bagatelle	lapalie
bagatelles	bagatelles
colis	bagage
bags	bags
baguette	baguette
bah	bah
bail	bail
bait	köder
faire cuire au four	backen
boulanger	bäcker
bakeries	bakeries
bakers	bakers
boulangerie	bäckerei
bakeshop	bakeshop
reliquat	saldo
balconies	balconies
balcon	altan
chauve	kahlköpfig
baldhead	baldhead
baldly	baldly
baldness	baldness
bale	bale
baleen	baleen
balk	hindern
bal	ball
ballad	ballade
ballade	ballade
ballads	ballads
ballast	ballast
ballet	ballett
balletic	balletic
aérostat	ärostat
ballot	ballot
balls	balls
ballyhoo	ballyhoo
beaume	balsam
bamboo	bambus
bamboozle	betrügen
banane	banane
bananas	bananas
bande	bande
bandage	bandage
bandeau	bandeau
bandit	bandit
bandits	bandits
bandleader	bandleader
bandmaster	bandmaster
bane	bane
banished	banished
barb	barb
barbarian	barbar
barbarians	barbarians
barbarism	barbarismus
coiffeur	barbier
barmaid	barmaid
barman	barman
caserne	kaserne
plage	strand
faire naître	aushalten
faire naître	aushalten
planche	beet
chambre à coucher	schlafzimmer
croire	glauben
trahir	verraten
bibliographic	bibliographic
bibliographies	bibliographies
bibliography	bibliographie
blackberry	brombeere
livre	buch
boomerang	boomerang
boxer	boxer
garçon	junge
boys	boys
cerveau	gehirn
brood	brood
balai	besen
broth	broth
construire	bauen
construction	anbau
adieu	adieu
cab	droschke
cabal	cabal
cabala	cabala
cabalism	cabalism
cabalist	cabalist
cabalistic	cabalistic
caballero	caballero
cabaret	cabaret
chou	kohl
cabbages	cabbages
cabdriver	cabdriver
cabane	hütte
armoire	kabinett
cabinetmaker	cabinetmaker
cabinetmakers	cabinetmakers
cabinets	cabinets
cabins	cabins
câble	kabel
cabled	cabled
cablegram	cablegram
cablegrams	cablegrams
cables	cables
cabling	cabling
cabman	chauffeur
caboose	caboose
cabotage	cabotage
cabriolet	cabriolet
cabs	cabs
cacao	cacao
cacciatore	cacciatore
cachalot	cachalot
cache	cache
cachepot	cachepot
caches	caches
cackle	cackle
cackled	cackled
cackles	cackles
cackling	cackling
cacophony	cacophony
cacti	cacti
cactus	kaktus
cad	cad
cadavre	kadaver
cadaverous	cadaverous
caddies	caddies
caddy	caddy
cadence	cadence
cadet	cadet
cadetship	cadetship
cadge	cadge
cadger	cadger
cafe	cafe
cafes	cafes
cafeteria	cafeteria
cafeterias	cafeterias
caffeine	caffeine
caftan	kaftan
cage	bauer
cages	cages
cahier	cahier
cairn	cairn
cairns	cairns
caitiff	caitiff
cajole	cajole
cajoler	cajoler
cajolery	cajolery
gâteau	kuchen
gâteau	kuchen
calcium	kalcium
calculer	erachten
calculated	calculated
calibrate	calibrieren
calibrated	calibrated
calibration	calibration
auto	auto
carbonization	carbonization
carbonize	carbonize
carbonized	carbonized
carbonless	carbonless
carburetor	carburetor
carburetors	carburetors
carburization	carburization
carburize	carburize
carte	karte
cardamom	cardamom
cordial	cardiac
cardigan	cardigan
cardioid	cardioid
cardioids	cardioids
avoir soin de	sorge tragen
avoir soin de	sorge tragen
cared	cared
career	karriere
prudent	bedächtig
carefully	sorgfältig
mégère	katze
cachot	karzer
cellular	cellular
hasard	zufällig
cherries	die kirschen
église	kirche
churches	churches
manteau	mantel
cloaks	cloaks
horloge	uhr
clockmaker	clockmaker
clockwise	clockwise
cloister	cloister
clone	clone
nuage	wolke
clouds	clouds
charbon	kohle
ordinateur	computer
computers	computers
comrades	comrades
concealed	concealed
conjuring	conjuring
contempler	contemplate
contempler	contemplate
contempler	contemplate
contemplates	contemplates
contemplation	contemplation
contemplation	contemplation
contemplation	contemplation
contemplations	contemplations
contemplations	contemplations
contemplative	contemplative
contemporaneous	contemporaneous
contemporaneously	contemporaneously
contemporaries	contemporaries
contemporaries	contemporaries
contemporary	zeitgenössisch
contemporary	zeitgenössisch
contempt	verachtung
contempt	verachtung
contemptible	contemptible
contemptibly	contemptibly
contemptuous	contemptuous
contemptuous	contemptuous
contemptuously	contemptuously
contemptuously	contemptuously
contend	contend
contend	contend
contend	contend
contender	contender
contender	contender
contender	contender
contenders	contenders
contenders	contenders
contenders	contenders
contending	contending
contending	contending
contends	contends
contends	contends
content	inhalt
content	inhalt
content	inhalt
content	zufrieden
content	zufrieden
contentedly	contentedly
contentedness	contentedness
contention	contention
contention	contention
contention	contention
contentions	contentions
contentions	contentions
contentions	contentions
contentious	contentious
contentious	contentious
contentment	contentment
contenu	inhalt
contenu	inhalt
concours	konkurrenz-prüfung
concours	konkurrenz-prüfung
concours	konkurrenz-prüfung
contestant	contestant
contestant	contestant
cot	kinderbett
coterie	coterie
cotillion	cotillion
cotillon	cotillon
cottage	häuschen
cottager	cottager
canapé	couch
tousser	husten
coughs	coughs
comte	rechne
countenance	angesicht
counteract	counteract
counterbalance	counterbalance
countermand	countermand
countermarch	countermarch
counterplot	counterplot
counterpoint	counterpoint
counterpoise	counterpoise
counterweight	counterweight
countess	countess
countless	zahllos
campagne	gefilde
paysan	countryman
countrywide	countrywide
county	county
couple	ehepaar
couplet	couplet
coupon	coupon
courage	mut
courageux	beherzt
courageously	courageously
courier	courier
piste	kurs
courser	courser
cour	den hof machen
courtois	artig
courteously	courteously
courteousness	courteousness
courtesy	courtesy
courthouse	courthouse
courtier	courtier
courtliness	courtliness
courtly	courtly
courtmartial	courtmartial
courtroom	gericht
courtship	courtship
cousine	base
cove	cove
covenant	vereinbarungen
couvrir	einband
covert	covert
covet	gelüsten
covetous	covetous
covetously	covetously
vache	kuh
vache	kuh
peureux	coward
faiblesse	cowardice
cowardly	cowardly
être accroupi	kauern
cowherd	cowherd
cowl	kappe
coxcomb	coxcomb
coy	coy
coyly	coyly
coyness	coyness
coyote	coyote
cozily	cozily
cozy	cozy
crabapple	crabapple
crabbed	crabbed
craquer	spalte
cracker	cracker
crackle	knistern
cradle	wiege
craft	craft
craftily	craftily
crag	crag
cram	cram
cramp	cramp
cranberry	cranberry
grue	kranich
cranium	cranium
crankiness	crankiness
cranky	cranky
crape	crape
crash	crash
crate	crate
crater	crater
crave	crave
craven	feig
ramper	kriechen
écrevisse	krebs
crayon	buntstift
craze	wut
crazily	crazily
fou	irre
grincer	fletschen
crème	rahm
creamy	creamy
froisser	zerknittern
créer	schaffen
creation	creation
creator	creator
créature	gebilde
credence	credence
lettre de créance	credential
credit	kredit
creditable	creditable
creditably	creditably
creditor	gläubiger
credo	credo
credulity	credulity
credulous	leichtgläubig
credulously	credulously
creed	creed
creek	creek
ramper	kriechen
creeps	creeps
cremate	brennen
faucher	mähen
cute	süss
cute	süss
cuteness	cuteness
cutoffs	cutoffs
cutout	cutout
cuts	schneidet
cutter	cutter
cutting	cutting
cyanate	cyanate
cyanide	cyanide
cybernetic	cybernetic
cybernetician	cybernetician
cybernetics	cybernetics
bécane	fahrrad
cyclic	cyclic
cyclical	cyclical
cyclist	cyclist
cyclists	cyclists
cycloid	cycloid
cycloidal	cycloidal
cyclone	wirbelwind
cyclonic	cyclonic
cyclopean	cyclopean
cyclotron	cyclotron
cylindre	walze
papa	väterchen
daddies	daddies
papa	väterchen
dads	dads
daffy	verrückt
daft	verrückt
dagger	dolch
dahlia	dahlia
dahlias	dahlias
journalier	täglich
daintier	daintier
aimable	delikat
dairy	milchgeschäft
dalmate	dalmatian
dalmatians	dalmatians
dam	gehege
endommager	beschädigen
endommager	beschädigen
endommager	beschädigen
endommager	beschädigen
damaged	damaged
damaged	damaged
damager	damager
damagers	damagers
damages	schäden
damaging	damaging
dame	dame
dammit	dammit
damnation	damnation
damned	damned
damp	feucht
dampen	dampen
dampened	dampened
dampness	dampness
dams	dams
bal	ball
dancer	der tänzer
dancers	dancers
dancing	dancing
pissenlit	hundebluhme
dandelions	dandelions
dandies	dandies
dandruff	dandruff
danger	gefahr
dangereux	besorglich
dart	dart
jour	tag
point du jour	tagesanbruch
daylight	daylight
days	tagen
deactivate	deactivate
deactivation	deactivation
dead	sterblich
sourd	taub
deaths	deaths
profond	tief
density	dichte
mériter	verdienen
detat	detat
detre	detre
appareil	apparat
appareil	apparat
dictated	dictated
dictates	dictates
dictation	dictation
dictations	dictations
dictionaries	wörterbücher
dictionnaire	wörterbuch
did	machte
décéder	sterben
died	died
diesel	diesel
diète	diät
dietetically	dietetically
diets	diets
différent	verschieden
difficulties	schwierigkeiten
difficulty	schwierigkeit
creuser	ausgraben
digested	digested
dignitaries	dignitaries
dignities	dignities
dignité	würde
dilate	erweitern
dilated	dilated
docteur	doktor
doeuvre	doeuvre
chien	hund
doggie	doggie
dogs	dogs
s'enivrer	saufen
drinks	drinks
amener à	anfeuern
drizzle	drizzle
sec	trocken
canard	ente
chaque	jede
aigle	adler
eagles	eagles
eaglet	eaglet
oreille	ohr
earache	earache
eardrum	eardrum
eardrums	eardrums
earlobe	earlobe
hâtif	früh
gagner	erringen
earning	earning
earphones	earphones
earring	earring
earrings	ohrring
ears	ohren
butter	boden
earthquake	erdbeben
earthquakes	earthquakes
earths	earths
earthworm	regenwurm
earthworms	earthworms
earwax	earwax
ease	ease
établi	arbeitsbock
easier	easier
easiest	leichteste
facilement	easily
easiness	easiness
est	orient
pâques	ostern
facile	leicht
déjeuner	essen
eatable	eatable
eats	eats
ebony	ebony
eccentric	eccentric
eccentricity	eccentricity
ecclesiastic	geistlich
écho	echo
eclipse	eclipse
ecologic	ecologic
ecologist	ecologist
ecology	ecology
economics	economics
ecru	ecru
huit	acht
dix-huit	achtzehn
eighteenth	eighteenth
eightfold	eightfold
eighth	eighth
eighties	eighties
eightieth	eightieth
eighty	achtzig
eightyfold	eightyfold
einsteinium	einsteinium
either	jede
ejaculate	ausrufen
ejaculated	ejaculated
ejaculates	ejaculates
ejaculating	ejaculating
ejaculation	ejaculation
ejaculations	ejaculations
ejaculatory	ejaculatory
eject	eject
ejectable	ejectable
ejecting	ejecting
ejection	ejection
ejector	ejector
ejectors	ejectors
elaborate	elaborate
elaborated	elaborated
elaborates	elaborates
elaborating	elaborating
elaboration	ausarbeitung
elaborations	elaborations
ascenseur	aufzug
onze	elf
eleventh	eleventh
eliminate	ausschalten
cesser	beschließen
milieu	milieu
envoy	bote
envier	beneiden
envier	beneiden
escalator	rolltreppe
fonder	gründen
événement	begebenheit
éventuel	etwaig
eventually	gegebenfalls
jadis	ehemals
evergreen	evergreen
infini	endlos
every	jede
partout	allenthalben
eviction	eviction
evidence	erweis
exclaim	ausrufen
fable	fabel
fables	fables
fabric	gewebe
fabricant	fabricant
fabriquer	anfertigen
fabricated	fabricated
fabricates	fabricates
fabricating	fabricating
fabrication	fabrication
fabrications	fabrications
fabricator	fabricator
fabricators	fabricators
fabrics	fabrics
fabulist	fabulist
fabulous	fabulous
façade	fassade
facades	facades
faceless	faceless
faceplate	faceplate
facet	facet
facetious	scherzhaft
facetious	scherzhaft
facetiously	facetiously
facial	facial
facies	facies
facile	geläufig
faciliter	erleichtern
facilitated	facilitated
facilitates	facilitates
facilitating	facilitating
facilities	möglichkeiten
facility	hilfsmittel
facing	facing
facsimile	facsimile
fact	tatsache
parti	fraktion
factor	factor
factorial	fakultaet
factorials	factorials
factories	factories
factorization	factorization
factorizations	factorizations
factorize	factorize
factorized	factorized
factors	factors
usine	fabrik
facts	facts
factual	faktisch
facultative	facultative
facultatively	facultatively
faculties	faculties
faculté	fakultät
fad	fad
pâlir	erblassen
faded	faded
fader	fader
faders	faders
fading	fading
faery	faery
faience	faience
fail	unterlassen
faible	flau
faintly	faintly
foire	basar
relativement	ziemlich
fée	fee
fidèle	gläubig
faithfully	faithfully
actuel	fashionable
jeûner	schnell
fastener	fastener
fastidious	wählerisch
épais	dick
fatal	fatal
fatalism	fatalism
fatality	fatality
fatally	fatally
destination	bestimmung
pêcher	fischen
fishable	fishable
fishbowl	fishbowl
fished	fished
fisher	fisher
fisheries	fisheries
pêcheur	fisherman
fishermen	fishermen
fishers	fishers
fishery	fishery
fishes	fishes
fishing	angeln
fishtail	fishtail
fission	fission
fissionable	fissionable
fissure	fissure
poing	faust
fisted	fisted
fistful	fistful
cinq	fünf
fivefold	fivefold
déterminer	anberaumen
fixation	fixation
fixations	fixations
fixity	fixity
fixture	fixture
fixtures	fixtures
fiord	fjord
fjords	fjords
fuite	flug
floppy	diskette
fluently	fluently
patte	fuß
foot	fußball
oublier	vergessen
forgetful	vergeßlich
forgetfulness	forgetfulness
forgivable	forgivable
forgivably	forgivably
excuser	entschuldigen
forgiveness	forgiveness
forgives	forgives
forgiving	forgiving
forgo	forgo
forgoes	forgoes
forgotten	forgotten
forlorn	forlorn
formaldehyde	formaldehyde
quatre	vier
renard	fuchs
fractal	fractal
fractals	fractals
fraction	fraktion
fractionate	fractionate
fraternal	fraternal
fraternize	fraternize
amie	freundin
amitié	freundschaft
fringe	fringe
grenouille	frosch
frogs	frogs
de	als
front	front
fucked	fucked
fudge	fudge
fugue	fugue
fulgurant	fulgurant
peureux	angst
funniest	funniest
amusant	drollig
gab	gab
gabardine	gabardine
gabber	gabber
gabbing	gabbing
gaberdine	gaberdine
gadget	hilfsmittel
gaiety	freuen
gaily	frohes
acquisition	errungenschaft
gained	gained
gaining	gaining
gala	gala
galactic	galactic
galaxy	galaxy
brave	brav
gallantly	gallantly
gallantry	gallantry
galleries	galleries
galerie	galerie
gallon	gallon
gallop	galopp
galloped	galloped
galloping	galloping
galvanic	galvanic
galvanism	galvanism
galvanize	galvanize
galvanized	galvanized
jeu	aufführung
games	spiels
ail	knoblauch
gaz	gas
essence	benzin
ghostwriter	ghostwriter
don	angebinde
gifts	gifts
aller	fahren
but	ziel
goals	ziel
chèvre	ziege
dieu	gott
goddess	goddess
goddesses	goddesses
parrain	gevatter
golfe	bucht
golfer	golfer
golfers	golfers
golfs	golfs
bon	gut
bon	gut
adieu	adieu
goodnight	goodnight
gopher	gopher
robe	kleid
saisir	greifen
gradient	gradient
de proche en proche	allmählich
grammaire	grammatik
raisin	traube
pamplemousse	die grapefruit
habilitated	habilitated
habilitation	habilitation
coutume	angewohnheit
habitant	habitant
habitants	habitants
habitat	habitat
habitation	hausen
habitual	habitual
had	hatte
ouvrier	einhändigen
guider	führen
heats	heats
ciel	himmel
lourd	schwer
hectare	hectare
hectares	hectares
hectoliter	hectoliter
hedgehog	igel
heed	heed
talon	ferse
heeler	heeler
heels	heels
altitude	höhe
held	hielt
helices	helices
hell	dschehenna
hello	hello
gouvernail	lenkrad
helmet	helm
aider	hilfe
hemp	hanf
poulet	huhn
troupeau	herd
ici	hierher
héron	reiher
hips	hips
battre	hauen
hockey	hockey
hogwash	hogwash
holidayer	holidayer
holidays	holidays
domicile	nach hause
homeless	homeless
homes	heim
maison	haus
crème glacée	eis
instancing	instancing
internship	internship
jab	jab
jabber	jabber
jabberwocky	jabberwocky
jabberwocky	jabberwocky
bambin	bube
jackal	schakal
jackals	jackals
jackass	jackass
jackdaw	jackdaw
veste	jacke
veste	jacke
jackknife	jackknife
jackpot	jackpot
jade	strapazieren
jaded	abgenutzt
jag	jag
jagged	uneben
prison	gefängnis
prison	gefängnis
jailbreak	jailbreak
jailed	jailed
jailer	jailer
jailing	jailing
jailor	jailor
jails	jails
jalopy	jalopy
confiture	konfitüre
confiture	konfitüre
jamb	jamb
jammed	jammed
jammed	jammed
jangle	jangle
janitor	der hausmeister
janitor	der hausmeister
jar	jar
jar	jar
jar	jar
jargon	jargon
jasmine	jasmine
jaundice	jaundice
jaunt	jaunt
jaunty	jaunty
javelin	javelin
mâchoire	kiefer
gouffre	maul
jay	eichelhäher
jazz	jazz
jazzy	jazzy
jaloux	eifersüchtig
envie	eifersucht
jeer	jeer
jeer	jeer
jelly	gelee
jellyfish	die qualle
jeopardize	jeopardize
jeopardize	jeopardize
jerk	erschüttern
jerk	erschüttern
jerry	deutschem
jersey	jersey
jersey	jersey
plaisanter	scherzen
jester	hanswurst
jester	hanswurst
jet	jet
jet	jet
jettison	jettison
jetty	jetty
bijou	gemme
jeweler	jeweler
jewelery	jewelery
jewelry	jewelry
jewels	jewels
jib	jib
jib	jib
jiffy	augenblick
jig	jig
jigsaw	jigsaw
jihad	jihad
jilt	jilt
tinter	klimpern
tinter	klimpern
tinter	klimpern
jinx	jinx
jitters	nervosität
ouvrage	arbeit
ouvrage	arbeit
ouvrage	arbeit
jobless	arbeitslos
jockey	jockey
jocular	jovial
jocund	jocund
jodhpur	jodhpur
jog	jog
jogging	jogging
adhérer	verbinden
adhérer	verbinden
joinable	joinable
joined	joined
joiner	joiner
joinery	joinery
articulation	fuge
articulation	fuge
articulation	fuge
jointly	gemeinsames
plaisanter	scherzen
plaisanter	scherzen
joked	joked
joker	joker
jokingly	jokingly
jokingly	jokingly
jolly	jolly
jolt	erschüttern
jolt	erschüttern
jonquils	jonquils
jostle	jostle
jot	jot
jot	jot
journal	journal
journal	journal
journalism	journalism
journaliste	journalist
journalists	journalists
voyage	reise
voyage	reise
jovial	gemütlich
jovially	jovially
joie	freude
joyful	joyful
joyless	joyless
joyously	joyously
jubilee	jubelfeier
juger	richten
juger	richten
judged	judged
arrêt	urteil
judicial	judicial
judiciary	judiciary
judo	judo
cruche	kanne
cruche	kanne
cruche	kanne
juggernaut	juggernaut
jongler	gaukeln
juggler	jongleur
jugular	jugular
jus	saft
juiceless	juiceless
juicier	juicier
juiciest	juiciest
juicy	juicy
jukebox	jukebox
jumble	bewegen
jumbo	jumbo
sauter	springen
jumped	jumped
jumpy	jumpy
junction	union
junction	union
jungle	jungle
junior	junior
juniper	juniper
junk	junk
junk	junk
junk	junk
junk	junk
junkers	junkers
junkers	junkers
junkie	junkie
junkie	junkie
junkyard	junkyard
juridic	juridic
jurisdiction	jurisdiction
jurist	jurist
juror	juror
jurors	jurors
jury	geschworene
juste	billig
justice	gerechtigkeit
justified	justified
justify	justify
justly	justly
jut	jut
juvenile	juvenile
juxtapose	juxtapose
kale	kohl
kaleidescope	kaleidescope
kaleidoscope	kaleidoscope
kangaroo	kängeruh
karat	karat
karate	karate
kayak	kayak
kebab	kebab
keel	kiel
continuer	bewahren
keeps	keeps
souvenir	andenken
keg	keg
keg	keg
kennel	kennel
kennel	kennel
kerchief	kerchief
centre	kern
centre	kern
centre	kern
kerosene	kerosene
ketchup	ketchup
chaudron	kessel
touche	schlüssel/taste
touche	schlüssel/taste
touche	schlüssel/taste
keyboard	tastatur
keyhole	keyhole
keying	keying
keynote	keynote
keypad	keypad
khaki	khaki
kick	stampfen
kick	stampfen
kickback	kickback
kicked	kicked
kicker	kicker
kickoff	kickoff
kicks	kicks
kid	zicklein
kid	zicklein
kid	zicklein
kiddies	kiddies
kiddies	kiddies
kiddies	kiddies
kidnap	kidnap
kidnaped	kidnaped
kidnaper	kidnaper
kidnaper	kidnaper
kidnapers	kidnapers
kidnaping	kidnaping
kidnapped	kidnapped
kidnapper	kidnapper
kidnappers	kidnappers
kidnapping	kidnapping
kidnappings	kidnappings
rein	niere
kidneys	kidneys
kidneys	kidneys
kids	kids
kids	kids
rectifier	ermorden
rectifier	ermorden
killer	killer
killer	killer
killers	killers
killing	killing
killing	killing
killings	killings
killjoy	killjoy
cuisinière	herd
kilogramme	kilogramm
kilogram	kilogram
kilohertz	kilohertz
kiloliter	kiloliter
kilomètre	kilometer
kilowatt	kilowatt
kilt	kilt
kin	verwand
affable	freundlich
affable	freundlich
affable	freundlich
kindergarten	kindergarten
kindergarten	kindergarten
kindergarten	kindergarten
kindergarten	kindergarten
kindhearted	kindhearted
kindhearted	kindhearted
kindheartedness	kindheartedness
allumer	zünden
allumer	zünden
kindlessly	kindlessly
kindlessly	kindlessly
kindliness	kindliness
kindliness	kindliness
kindly	kindly
kindly	kindly
kindly	kindly
kindly	kindly
amabilité	freundlichkeit
amabilité	freundlichkeit
kindred	kindred
kindred	kindred
kinds	freundlicher
kinds	freundlicher
roi	könig
royaume	königreich
royaume	königreich
kingdoms	kingdoms
martin-pêcheur	eisvogel
kingly	kingly
kings	kings
kinky	kinky
kiosk	kiosk
kipper	kipper
embrasser	küssen
embrasser	küssen
embrasser	küssen
embrasser	küssen
kisses	kisses
kisses	kisses
kit	bausatz
kit	bausatz
cuisine	küche
kitchenette	kitchenette
kitchens	kitchens
kitchenware	kitchenware
kitchenware	kitchenware
kite	drachen
kith	kith
kiting	kiting
kitten	kätzchen
kittens	kittens
kitty	kitty
kiwi	kiwi
kiwi	kiwi
kleenex	kleenex
kleenex	kleenex
kleptomania	kleptomania
kleptomaniac	kleptomaniac
knack	knack
knack	knack
sac tyrolien	tornister
pétrir	kneten
kneadable	kneadable
kneader	kneader
genou	knie
kneecap	kneecap
s'agenouiller	kneel
s'agenouiller	kneel
kneeling	kneeling
kneeling	kneeling
kneepad	kneepad
knelt	knelt
knelt	knelt
knickers	knickers
knickknack	knickknack
knickknack	knickknack
couteau	messer
couteau	messer
knifes	knifes
knifing	knifing
chevalier	kämpe
chevalier	kämpe
knighted	knighted
knighthood	knighthood
knightly	knightly
knights	knights
tricoter	stricken
tricoter	stricken
tricoter	stricken
knitted	knitted
knitting	knitting
knitwear	knitwear
knives	knives
knob	gefäß
knob	gefäß
knobby	knobby
knobs	knobs
frapper	klopfen
knockdown	knockdown
knockout	knockout
nouer	knoten
knots	knots
knotted	knotted
knotty	knotty
connaître	kennen
knower	knower
knowhow	knowhow
knowhow	knowhow
knowing	weiss
knowingly	knowingly
knowingly	knowingly
connaissance	begriff
connaissance	begriff
knowledgeable	kundig
known	known
knows	weisst
knuckle	knuckle
knuckle	knuckle
knucklebone	knucklebone
knuckles	knuckles
koala	koala
koala	koala
kosher	kosher
kraut	kraut
kraut	kraut
krauts	krauts
kudzu	kudzu
lab	lab
labor	arbeiten
ouvrier	arbeiter
ouvrier	arbeiter
laborers	laborers
dentelle	spitze
laceration	laceration
lacerations	lacerations
défaut	fehlen
lackadaisical	lackadaisical
lackey	bedienter
lacking	lacking
lackluster	lackluster
laconic	laconic
laconically	laconically
lacquer	firnissen
lacquer	firnissen
lad	junge
ladies	damen
dame	dame
ladybird	ladybird
ladybug	marienkäfer
lac	see
lakes	lakes
agneau	lamm
lambs	lambs
laminated	laminated
laminates	laminates
lampe	lampe
langue	sprache
rire	lachen
cuir	ledern
partir	abreisen
pupitre	pult
conférence	vortrag
lecturer	lektor
ledge	regal
ledger	ledger
lee	lee
jambe	bein
légitime	legal
legality	legality
legalize	legalize
legally	legally
legate	legate
legation	legation
legend	legende
legendary	legendary
legion	legion
lettre	epistel
lettre	epistel
lettre	epistel
comme	achten
demeurer	hausen
aimer	gern haben
aimer	gern haben
amante	freier
destinée	glück
lunch	lunch
ma	mutti
ma	mutti
maam	maam
maam	maam
maam	maam
macabre	macabre
macabre	macabre
macabrely	macabrely
macadam	macadam
macadam	macadam
macadamize	macadamize
macadamize	macadamize
macadamized	macadamized
macadamized	macadamized
macadamizes	macadamizes
macadamizes	macadamizes
macadamizing	macadamizing
macaque	macaque
macaque	macaque
macaroni	makkaroni
macaronies	macaronies
macaroon	macaroon
macaw	macaw
mace	mace
macerate	macerate
macerated	macerated
maceration	maceration
macerations	macerations
maces	maces
machete	machete
machination	machination
machined	machined
machineries	machineries
machinery	maschinerie
machines	machines
machinist	machinist
machinists	machinists
machismo	machismo
macho	macho
macrocephalic	macrocephalic
macrocosm	macrocosm
macroeconomics	macroeconomics
macroevolution	macroevolution
macroevolutionary	macroevolutionary
macroinstruction	macroinstruction
macromolecular	macromolecular
macromolecule	macromolecule
macromolecules	macromolecules
macropathological	macropathological
macropathology	macropathology
macrophage	macrophage
macrophages	macrophages
macrophagic	macrophagic
macroprocessor	macroprocessor
macroscopic	macroscopic
macrosimulation	macrosimulation
macrostructure	macrostructure
maculate	maculate
maculated	maculated
maculates	maculates
maculation	maculation
maculations	maculations
fou	irre
fou	irre
madame	frau
madams	madams
maddened	maddened
made	made
made	made
mademoiselle	mademoiselle
mademoiselles	mademoiselles
maestro	meister
mafioso	mafioso
gazette	zeitung
magie	magie
magician	zauberer
magicians	magicians
magistral	magistral
magistrally	magistrally
magistrature	magistrature
magma	magma
me	mir
mead	mead
prairie	anger
prairie	anger
meadowland	meadowland
meadows	meadows
maigre	mager
meagerly	meagerly
meagre	meagre
farine	mehl
meals	meals
moyenne	beabsichtigen
meander	sich schlängeln
meaningless	meaningless
meanings	bedeutung
instrument	bedeutet
viande	fleisch
meats	meats
meatball	meatball
meatballs	meatballs
mechanical	mechaniker
mechanician	mechanician
mechanism	mechanism
mechanisms	mechanisms
médaille	denkmünze
medallion	medallion
medallions	medallions
mediatrice	mediatrice
mediatrix	mediatrix
medic	medic
medical	medizinisch
medically	medically
medicament	medicament
medicaments	medicaments
medicinal	medicinal
remède	medizin
medicines	medicines
medico	medico
medicolegal	medicolegal
medics	medics
medieval	medieval
medievalist	medievalist
medievalists	medievalists
mediocre	mediocre
mediocrity	mediocrity
méditer	erwägen
meditates	meditates
meditation	meditation
meditations	meditations
meditative	meditative
medium	mittels
medlar	medlar
medley	medley
medleys	medleys
medulla	medulla
medusae	medusae
meek	meek
meekly	meekly
meekness	meekness
meerschaum	meerschaum
megabyte	megabyte
megabytes	megabytes
megacycle	megacycle
megahertz	megahertz
megalith	megalith
megalithic	megalithic
megalomania	megalomania
megalomaniac	megalomaniac
megalomaniacal	megalomaniacal
megaphone	megaphone
melancholia	melancholia
melancholic	melancholic
melange	melange
melodic	melodic
melodies	melodies
melodious	melodious
melodrama	melodram
melodramas	melodramas
melodramatic	melodramatic
mélodie	melodie
melon	melone
melons	melons
melted	melted
adhérent	anhänger
members	members
membrane	membrane
membranes	membranes
membranous	membranous
memoir	memoir
memoirs	memoirs
memorable	memorable
memories	memories
apprendre par cœur	memorize
memorized	memorized
men	männer
gronder	bevorstehen
menagerie	menagerie
menageries	menageries
menhir	menhir
meningitis	meningitis
meniscus	meniscus
menopause	menopause
menstrual	menstrual
menstruation	menstruation
menstruations	menstruations
intellectuel	mental
mentality	mentality
menthol	menthol
mentionner	nennen
carte	menü
meow	meow
meowing	meowing
meows	meows
mephitic	mephitic
mercantile	mercantile
mercantilism	mercantilism
mercenaries	mercenaries
mercenary	mercenary
commerçant	händler
merchants	merchants
mercure	quecksilber
compassion	barmherzigkeit
meridian	meridian
meridional	meridional
mériter	verdienen
meritocracy	meritocracy
merits	merits
mermaid	die meerjungfrau
mermaids	mermaids
gai	wohlgemut
message	auskunft
messages	mitteilungen
messiahs	messiahs
messianic	messianic
gémir	ächzen
moaned	moaned
moaning	moaning
moans	moans
moat	moat
moats	moats
mob	mob
se moquer	äffen
mocked	mocked
simulacre	spott
modal	modal
moonlight	mondschein
élan	elch
naïf	naiv
naively	naively
nu	bloß
nom	name
named	named
nameless	nameless
namely	zwar
namely	zwar
names	names
national	national
nationalism	nationalism
nationalist	nationalist
inné	angeboren
naturel	natürlich
naturalize	naturalize
bien sûr	natürlich
neap	neap
près	beiläufig
nearer	näher
dédaigner	unterlassen
voisin	nachbar
neighbors	neighbors
filet	garn
networked	networked
networks	netzwerk
neuf	neun
dix-neuf	neunzehn
nineteenth	nineteenth
nineties	nineties
ninetieth	ninetieth
ninety	neunzig
ninetyfold	ninetyfold
ninth	ninth
niobium	niobium
nip	nip
mamelon	zitze
nipples	nipples
nips	nips
nirvana	nirvana
nitrate	nitrate
nitrated	nitrated
nitrates	nitrates
nitrating	nitrating
nitration	nitration
nitrations	nitrations
nitric	nitric
nitride	nitride
azote	stickstoff
nitroglycerin	nitroglycerin
nitroglycerine	nitroglycerine
élevé	edel
noble	adeliger
noblemen	noblemen
grandeur	edelmut
nul	keine
noctambulism	noctambulism
noctambulist	noctambulist
nocturn	nocturn
nocturnally	nocturnally
eh bien	nu
actuellement	heutzutage
noway	noway
noway	noway
oaf	oaf
oafishness	oafishness
chêne	eiche
rame	ruder
oarsman	oarsman
oasis	oase
oat	hafer
serment	eid
oatmeal	oatmeal
obdurate	obdurate
obedience	obedience
docile	folgsam
obelisk	obelisk
obese	fett
obesity	obesity
océan	ozean
on	ein
orange	apfelsine
oranges	oranges
orbit	orbit
orbital	orbital
orbits	orbits
orchestre	orchester
orchestral	orchestral
orchestras	orchestras
orchestrated	orchestrated
commander	befehlen
ordered	ordered
organism	organismus
organisms	organisms
organist	organist
organists	organists
organization	einrichtung
organizations	organizations
organiser	einrichten
organized	organized
organs	organs
orgasm	orgasm
orgasms	orgasms
orgies	orgies
orgie	orgie
orient	orient
orientable	orientable
orientation	orientation
orientations	orientations
oriented	oriented
orients	orients
orifice	orifice
orifices	orifices
orificial	orificial
origine	ursprung
inédit	ursprünglich
originality	originality
originally	originally
originals	originals
origins	origins
ornamental	ornamental
ornithology	ornithology
orthodoxe	orthodox
orthodoxes	orthodoxes
orthogonal	orthogonal
faire les cent pas	schreiten
faire les cent pas	schreiten
pachyderm	pachyderm
pacifique	stillen
pacifically	pacifically
pacification	pacification
pacifications	pacifications
pacificist	pacificist
pacifier	pacifier
pacifism	pacifism
pacifist	pazifist
pacify	pacify
pacify	pacify
package	packen
package	packen
packaged	packaged
packaged	packaged
packed	packed
paquet	bündel
packing	packing
pact	pact
pacts	pacts
bloc	block
padding	padding
barbotter	paddeln
paddock	paddock
padlock	vorhängeschloss
padlock	vorhängeschloss
padrone	padrone
paella	paella
pagan	pagan
pagans	pagans
pageant	pageant
pageantry	pageantry
paid	paid
seau	eimer
douleur	schmerz
pained	pained
pénible	painful
pénible	painful
painfully	painfully
painstaking	painstaking
couleur	färben
couleur	färben
pinceau	pinsel
peintre	maler
painters	painters
painting	bild
paints	paints
paire	paar
pajamas	schlafanzug
camarade	genosse
camarade	genosse
palais	palast
palatable	palatable
palaver	palaver
pâle	blaß
palette	palette
pall	pall
pallet	pallet
pallette	pallette
pallor	pallor
paume	handfläche
paume	handfläche
palpable	palpable
palpable	palpable
paltry	paltry
brochure	broschüre
pan	pan
panacea	panacea
panama	panama
pancake	fladen
panda	der panda
pandemonium	pandemonium
pane	pane
lambris	paneel
paneling	paneling
panelling	panelling
pang	pang
panique	panik
panique	panik
panicky	panicky
panorama	panorama
pensée	stiefmütterchen
pant	pant
panthère	panther
caleçon	unterhose
buffet	speisekammer
pantalon	beinkleid
papa	papa
document	dokument
brochure	broschüre
parameter	parameter
passer	passer
ardeur	glut
passionately	passionately
passive	passive
passivity	passivity
password	passwort
passwords	passwords
passé	vergangenheit
pasta	pasta
pectorals	pectorals
drôle	befremdend
penitence	penitence
penitences	penitences
penitency	penitency
penitent	penitent
pentadactyl	pentadactyl
pentadactylism	pentadactylism
pi	pi
pianist	pianist
pianistic	pianistic
image	ansicht
pictures	pictures
pâté	pastete
pies	pies
cochon	schwein
spécialité	abteilung
pigment	pigment
pigmentation	pigmentation
pigments	pigments
pigs	pigs
pilote	lotsen
pilots	pilots
pilule	pilule
pin	föhre
ananas	ananas
pineapples	pineapples
pines	pines
pink	rosa
poche	tasche
pocketbook	brieftasche
pocketbooks	pocketbooks
pockets	pockets
estrade	podium
pogrom	pogrom
pogroms	pogroms
pointer	zeiger
pointillism	pointillism
pointillist	pointillist
pointilliste	pointilliste
pointillistic	pointillistic
poison	vergiften
poisonous	giftig
poisonousness	poisonousness
poisons	poisons
polar	polar
polarities	polarities
polarity	polarity
polarize	polarize
polarized	polarized
polemical	polemical
polemically	polemically
polemicize	polemicize
police	polizei
agent	polizist
agent	polizist
agent	polizist
policemen	policemen
policemen	policemen
policemen	policemen
policewoman	policewoman
policewomen	policewomen
politique	polize
polonais	polnisch
polonais	polnisch
courtois	artig
politely	politely
politesse	politeness
political	politisch
politically	politically
politician	politician
politicians	politicians
politique	politik
polka	polka
pollutant	pollutant
pollute	pollute
polluted	polluted
polluter	polluter
pollution	pollution
polonium	polonium
poltergeist	poltergeist
polyandrous	polyandrous
polyandry	polyandry
verser	gießen
pout	schmollen
poverty	armut
poudre	pudern
powdery	powdery
puissance	gewalt
puissant	gewältig
powerless	powerless
powwow	powwow
practicability	practicability
practicable	gangbar
réel	praktisch
prier	beten
prière	gebet
prayers	prayers
praying	praying
praying	praying
prêcher	predigen
prêcher	predigen
preacher	preacher
preacher	preacher
preachers	preachers
preachers	preachers
preaches	preaches
preaches	preaches
preachify	preachify
preaching	preaching
preaching	preaching
preaching	preaching
preachy	preachy
preachy	preachy
preamplifiers	preamplifiers
prearrange	prearrange
prearrange	prearrange
prince	fürst
princedom	princedom
princely	princely
princes	princes
princesse	fürstin
principal	hauptsächlich
principal	hauptsächlich
principalities	principalities
principality	fürstentum
principalement	besonders
principalement	besonders
principals	principals
principe	grundsatz
principles	principles
impression	drucken
impression	drucken
impression	drucken
printed	ausgedruckt
imprimeur	drucker
imprimeur	drucker
priorities	priorities
priorities	priorities
priority	priorität
démontrer	begründen
pouls	puls
pulverizable	pulverizable
pulverizables	pulverizables
pulverization	pulverization
moudre	mahlen
pulverized	pulverized
pulverizer	pulverizer
pulverizers	pulverizers
pulverizes	pulverizes
pulverizing	pulverizing
puma	puma
pomper	pumpen
pousser	dringen
pushchair	pushchair
pushing	pushing
appliquer	legen
putdown	putdown
putout	putout
putrefaction	putrefaction
quail	wachtel
quails	quails
quake	quake
propriété	art
qualm	qualm
qualms	qualms
quantité	menge
se disputer	disput
quarry	quarry
quartier	quartier
quarterdeck	quarterdeck
quarterfinal	quarterfinal
queen	königin
queer	wunderlich
étouffer	erdrosseln
quench	quench
querulous	querulous
query	anfrage
recherche	nachsuchung
question	frage
queue	queue
chicaner	schikanieren
prompt	geschwind
quicklime	quicklime
rapidement	flugs
quicksand	quicksand
quicksilver	quecksilber
calme	fromm
quieten	quieten
paisiblement	quietly
quill	quill
coudre	steppen
quirk	quirk
démissioner	abdanken
bien	sehr
quota	quote
citation	zitat
citer	anführen
r	r
rabbet	rabbet
rabbin	rabbiner
rabbinic	rabbinic
lapin	kaninchen
rabbits	rabbits
rabble	gesindel
rabid	rabid
rage	tollwut
raton laveur	raccoon
s'élancer	abkunft
racehorse	racehorse
racemic	racemic
racer	racer
races	races
rachis	rachis
rachitic	rachitic
rachitis	rachitis
racialism	racialism
racialist	racialist
racialistic	racialistic
racing	racing
racism	racism
racist	racist
rack	arrak
racket	schläger
racket	schläger
radar	radar
radars	radars
radio	radio
lire	lesen
readability	lesbarkeit
readable	readable
lecteur	reader
readers	readers
readership	readership
readership	readership
readily	gern
readily	gern
readily	gern
readiness	readiness
readiness	readiness
reading	lesung
reading	lesung
reading	lesung
readings	readings
readings	readings
readjust	readjust
readjusts	readjusts
readjusts	readjusts
readout	readout
readout	readout
readouts	readouts
reads	reads
prêt	bereit
prêt	bereit
prêt	bereit
reaffirm	reaffirm
reaffirm	reaffirm
reaffirms	reaffirms
reaffirms	reaffirms
reagent	reagent
effectif	effektiv
effectif	effektiv
effectif	effektiv
realisable	realisable
realism	realism
realist	realist
realistic	realistic
realistic	realistic
realistically	realistically
réalité	wahrheit
comprendre	begreifen
en réalité	tatsächlich
reporter	reporter
représenter	abbilden
demander	bitten
demander	bitten
demander	bitten
chemin	bahn
roads	roads
roadwork	roadwork
ravisseur	freibeuter
rotting	rotting
sabbat	sabbat
sabbath	sabbat
sabbatic	sabbatic
sabbatical	sabbatical
saber	saber
sabin	sabin
sable	sable
sabot	sabot
sabotage	sabotage
sabotaged	sabotaged
sabotages	sabotages
saboteur	saboteur
sabra	sabra
sabras	sabras
saccade	saccade
saccharin	saccharin
saccharine	saccharine
saccharose	saccharose
sacerdotal	sacerdotal
sacerdotally	sacerdotally
sachet	sachet
licencier	abdanken
licencier	abdanken
sackcloth	sackcloth
sacked	sacked
sackful	sackful
sacks	sacks
sacrament	sakrament
sacramental	sacramental
sacraments	sacraments
sacre	sacre
sacré	heilig
consacrer	erbieten
sacrificed	sacrificed
sacrifices	sacrifices
sacrilege	sakrilegium
affligé	düster
sadden	sadden
sadder	sadder
saddest	saddest
selle	sattel
saddlebag	saddlebag
saddlebags	saddlebags
saddlebow	saddlebow
saddlecloth	saddlecloth
saddled	saddled
saddleless	saddleless
saddler	saddler
saddlery	saddlery
saddles	saddles
saddletree	saddletree
sadism	sadism
sadist	sadist
sadistic	sadistic
sadistically	sadistically
sadists	sadists
sadly	sadly
affliction	betrübnis
safari	safari
à l'abri	sicher
safecracker	safecracker
safecracking	safecracking
safeguard	safeguard
safeguarded	safeguarded
safeguards	safeguards
safer	safer
safest	safest
sécurité	sicherheit
safflower	safflower
saffron	saffron
sag	sag
saga	saga
intelligent	einsichtsvoll
sagaciously	sagaciously
sagaciousness	sagaciousness
sagacity	sagacity
sauge	salbei
sagely	sagely
sago	sago
saguaro	saguaro
sahib	sahib
said	sagte
voile	segel
voile	segel
sailable	sailable
sailboat	das segelboat
sailboater	sailboater
sailcloth	sailcloth
sailors	sailors
sails	sails
sainfoin	sainfoin
saint	heiliger
sainted	sainted
sainthood	sainthood
saith	saith
sake	sake
salability	salability
salacious	salacious
salade	salat
salads	salads
salamander	der salamander
salaried	salaried
salaries	salaries
sale	absatz
saleable	saleable
saleroom	saleroom
salesclerk	salesclerk
salesgirl	salesgirl
saleslady	saleslady
marchand	ladengehilfe
salesmanship	salesmanship
salesmen	verkäufer
salespeople	salespeople
salesperson	salesperson
salesroom	salesroom
saleswoman	ladenfräulein
saleswomen	saleswomen
salient	salient
saline	saline
salinity	salinity
salinometer	salinometer
salinometers	salinometers
salive	speichel
salivary	salivary
salivate	salivate
salivated	salivated
salivates	salivates
salivating	salivating
salivation	salivation
sallies	sallies
pâle	blaß
sallowish	sallowish
saumon	lachs
salmons	salmons
salon	aula
salons	salons
saler	salzen
saltwater	saltwater
saltworks	saltworks
saltwort	saltwort
salty	salzen
salubrious	bekömmlich
salubrity	salubrity
salut	heil
salver	salver
samba	samba
identique	gleiche
sampan	sampan
samphire	samphire
samurai	samurai
samurais	samurais
sable	sand
sandale	sandale
école	schule
mer	meer
vendre	veräußern
seller	seller
sellers	sellers
serendipity	serendipity
serein	heiter
36770	sieben
sevenfold	sevenfold
dix-sept	siebzehn
seventeenth	seventeenth
seventh	seventh
seventies	seventies
seventieth	seventieth
seventy	siebzig
seventyfold	seventyfold
sever	sever
sévère	streng
severed	severed
severely	severely
severities	severities
severity	severity
sewage	sewage
sexe	geschlecht
sexagenarian	sexagenarian
sexual	generisch
sexually	sexually
shades	shades
ombre	schatten
shadows	shadows
shagreen	shagreen
schah	schah
secouer	erschüttern
shakedown	shakedown
shaken	shaken
shaky	shaky
shaman	shaman
shamanism	shamanism
shampoo	shampoo
shampoos	shampoos
mouton	hammel
sheepherder	sheepherder
expédier	abfertigen
expédier	abfertigen
shit	mist
malade	krank
argent	silber
chanter	singen
chanteuse	berufssänger
forer	tauchen
six	sechs
seize	sechzehn
sixteenth	sixteenth
sixties	sixties
soixante	sechzig
sixtyfold	sixtyfold
ampleur	ausdehnung
patin	rochen
skateboard	skateboard
skateboarder	skateboarder
skateboarding	skateboarding
skateboards	skateboards
skater	skater
skaters	skaters
skates	skates
skating	skating
adresse	geschicklichkeit
skilled	geübt
skilless	skilless
adroit	geübt
ciel	himmel
skylark	lerche
skyscraper	skyscraper
snout	snout
neiger	schneien
snowball	snowball
flocon de neige	schneeflocke
snowman	snowman
snowstorm	snowstorm
software	software
sorrily	sorrily
sorrow	betrübnis
sorte	abart
sorted	sorted
sorter	sorter
âme	gemüt
spectra	spectra
spectrum	spectrum
speculate	speculate
speculation	speculation
parenthèse	klammer
stapled	stapled
stapler	die heftmaschine
staplers	staplers
staples	staples
étoile	stern
stars	stars
activer	anstellen
stifled	stifled
force	stärke
sot	blödsinnig
sujet	subjekt
arriver	erfolg haben
prospérité	erfolg
soleil	sonne
sunbathe	sunbathe
sunny	sonnig
suppressed	suppressed
soupçonner	argwöhnen
blasphémer	lästern
tab	tab
tab	tab
tabernacle	tabernacle
liste	tabelle
tableau	tableau
tableaus	tableaus
tableaux	tableaux
tablecloth	tischtucher
tablecloths	tablecloths
tables	tables
liste	tabelle
tablets	tablets
taboos	taboos
tachometer	tachometer
tachometers	tachometers
tacit	tacit
queue	sterz
couturière	schneidern
tailored	tailored
tailors	tailors
habit	frack
devoir	arbeit
tasks	angaben
goût	schmecken
tasted	tasted
tasteless	fade
larme	zerreißen
larme	zerreißen
larme	zerreißen
larme	zerreißen
teardrop	teardrop
tearful	tearful
tearfully	tearfully
tearfully	tearfully
teargas	teargas
tearjerker	tearjerker
tearless	tearless
tearless	tearless
tearoom	tearoom
tears	tränen
tears	tränen
tearstained	tearstained
tearstained	tearstained
agacer	tease
agacer	tease
agacer	tease
teasel	teasel
teaser	teaser
teaser	teaser
teases	teases
teases	teases
teases	teases
teasing	teasing
teasing	teasing
teasingly	teasingly
teasingly	teasingly
teaspoon	teaspoon
teaspoon	teaspoon
teaspoonful	teaspoonful
mamelle	brust
mamelle	brust
mamelle	brust
mamelle	brust
teatime	teatime
teats	teats
teats	teats
dix	zehn
tendencies	tendencies
aptitude	stimmung
tenderfoot	tenderfoot
tenderly	zärtlich
thence	daher
thence	daher
thenceforth	thenceforth
thenceforward	thenceforward
theocracy	theocracy
theocratic	theocratic
theodolite	theodolite
theologian	theologe
theologians	theologians
theological	theological
theologically	theologically
theology	theologie
theorem	theorem
theorems	theorems
theoretical	theoretical
theoretical	theoretical
theoretically	theoretically
theoretician	theoretician
theoretician	theoretician
theoreticians	theoreticians
theoreticians	theoreticians
theorist	theorist
theorist	theorist
theorists	theorists
theorists	theorists
theorize	theorize
thief	dieb
quoique	obgleich
quoique	obgleich
pensée	gedanke
pensée	gedanke
thoughtful	thoughtful
thoughtfully	thoughtfully
précaution	vorsorge
thoughtless	thoughtless
thoughtlessly	thoughtlessly
thoughtlessness	thoughtlessness
mille	tausend
thousandth	thousandth
thrash	verhauen
thrash	verhauen
fil	faden
fil	faden
fil	faden
threadbare	threadbare
menace	bedrohung
gronder	bevorstehen
sinistre	threatening
threateningly	threateningly
trois	drei
tigress	tigress
aujourd'hui	heute
doigt du pied	zehe
tradition	tradition
traditional	traditionell
trail	geleise
clique	abrichten
trainee	trainee
trainer	trainer
traitor	traitor
transaction	transaction
transalpine	transalpine
transcribe	transcribe
passer	entern
traduire	übersetzen
translation	übersetzung
translator	übersetzer
adresser	schicken
arbre	baum
camiono	lastauto
deux	zwei
ubiquitous	ubiquitous
ubiquity	ubiquity
pis	euter
ugh	ugh
uglier	uglier
ugliest	ugliest
uglify	uglify
uglily	uglily
ugliness	ugliness
laid	häßlich
ukulele	ukulele
ulcère	geschwür
ulcerate	ulcerate
ulcerated	ulcerated
ulceration	ulceration
ulcerative	ulcerative
ulna	ulna
ultimo	ultimo
unemployment	arbeitlosigkeit
vacant	vacant
vacate	vacate
vacances	ferien
vacciner	impfen
vaccinated	vaccinated
vacuum	vacuum
vacuumed	vacuumed
vagin	vagina
vagrant	vagrant
vague	vague
vain	vergebens
wacky	wacky
wag	wag
noix	walnuß
warehouse	geschäft
warehouse	geschäft
warehouses	warehouses
laver	spülen
pleurer	tränen
weeping	weeping
weeping	weeping
weeps	weeps
weepy	weepy
weepy	weepy
weevil	weevil
weft	weft
peser	wägen
peser	wägen
weighing	weighing
weighings	weighings
weighs	weighs
poids	gewicht
weighted	weighted
weighted	weighted
weightily	weightily
weighting	weighting
weighting	weighting
weightless	weightless
weightlessness	gewichtslosigkeit
weights	weights
weights	weights
weighty	schwer
weighty	schwer
weir	weir
bizarre	seltsam
weirdie	weirdie
weirdies	weirdies
weirdly	weirdly
weirdness	weirdness
weirdness	weirdness
weirdo	weirdo
weirdos	weirdos
weirs	weirs
recevoir solennellement	willkommen
recevoir solennellement	willkommen
recevoir solennellement	willkommen
recevoir solennellement	willkommen
où	war
fenêtre	fenster
fenêtre	fenster
windowpane	windowpane
windowpanes	windowpanes
windows	windows
windstorm	windstorm
vin	wein
wineglass	wineglass
winegrower	winegrower
winemaker	winemaker
winemaking	winemaking
winepress	winepress
wines	wines
winey	winey
aile	fittich
winglet	winglet
wink	zwinkern
hiver	winter
effacer	wischen
fil	draht
fil	draht
fil	draht
wired	wired
radio	radio
wiring	wiring
wiry	wiry
intelligence	weisheit
raisonnable	gescheit
wisecrack	wisecrack
wisely	wisely
wiser	wiser
désirer	wünschen
désirer	wünschen
wishbone	wishbone
wishes	wünsche
wishful	wishful
witch	hexe
witches	witches
à	mit
décéder	zurückziehen
décéder	zurückziehen
sans	ohne
témoin	zeuge
témoin	zeuge
witnesses	witnesses
wolverine	wolverine
wolverine	wolverine
monde	welt
worldwide	universal
xenophobe	xenophobe
xenophobia	xenophobia
xenophobic	xenophobic
xerographic	xerographic
xylem	xylem
xylene	xylene
xylophone	xylophone
xylophones	xylophones
xylophonist	xylophonist
xylose	xylose
xylotomic	xylotomic
yacht	jacht
yachting	yachting
yachtsman	yachtsman
yak	yak
igname	yamswurzel
yap	yap
cour	hof
yardstick	yardstick
yarn	yarn
bâiller	gähnen
bâiller	gähnen
yawning	yawning
yeah	ja
an	jahr
yearbook	yearbook
yearlong	yearlong
annuellement	jährlich
annuellement	jährlich
aspirer	sich ersehnen
yearning	yearning
yearningly	yearningly
years	jahr
yeast	yeast
yell	heulen
yell	heulen
jaune	gelb
yellowed	yellowed
yellowing	yellowing
yellowish	yellowish
bien	ja
hier	gestern
encore	noch
yew	yew
abandonner	abtreten
yoga	yoga
yaourt	yoghurt
yogurt	yogurt
yoke	joch
yolk	yolk
te	du/sie
te	du/sie
jeune	jung
younger	jüngere
youngster	jüngling
youth	jugend
youthful	youthful
yuppie	yuppie
zabaglione	zabaglione
zany	zany
zazen	zazen
ferveur	eifer
fervent	eifrig
zèbre	zebra
zenith	zenit
zero	null
zero	null
vigueur	zest
zigzag	im zickzack gehen
zinc	zink
fermeture éclair	reissverschluss
zodiac	tierkreis
zodiac	tierkreis
zone	zone
zone	zone
zoo	zoo
zoology	zoologie
zoom	zoom
zucchini	zucchini
