à	ein/eit
à	ein/eit
aardvark	aardvark
aardvark	aardvark
aardvarks	aardvarks
aback	tilbake
aback	tilbake
aback	tilbake
abacterial	abacterial
abaque	abacus
abaque	abacus
abaque	abacus
abacuses	abacuses
abacuses	abacuses
abacuses	abacuses
abaft	abaft
abalone	abalone
abalones	abalones
abandonner	abandon
abandonner	abandon
immoral	abandoned
immoral	abandoned
immoral	abandoned
abandonee	abandonee
abandoner	abandoner
abandoning	abandoning
abandonment	abandonment
abandonment	abandonment
abandonments	abandonments
humilier	abase
abased	abased
abasement	abasement
abasements	abasements
abases	abases
abash	abash
abashed	abashed
abashed	abashed
abasing	abasing
diminuer	minske
diminuer	minske
abated	abated
rabais	abatement
rabais	abatement
abatements	abatements
abates	abates
abating	abating
abating	abating
boucherie	abattoir
abbe	abbe
abberations	abberations
abbaye	abbedi
abbaye	abbedi
abbeys	abbeys
abbé	abbot
abbé	abbot
abbé	abbot
abbé	abbot
abbé	abbot
abbots	abbots
raccourcir	abbreviate
raccourcir	abbreviate
abbreviated	abbreviated
abbreviates	abbreviates
abbreviating	abbreviating
abbreviation	forkortelse
abbreviation	forkortelse
abbreviation	forkortelse
abbreviations	abbreviations
abbreviations	abbreviations
abbreviator	abbreviator
abdicable	abdicable
abdiquer	abdicate
abdiquer	abdicate
abdicated	abdicated
abdication	abdication
abdicator	abdicator
abdomen	abdomen
abdomen	abdomen
abdomens	abdomens
abdominal	abdominal
abdominally	abdominally
abduct	abduct
abducted	abducted
abducting	abducting
abduction	abduction
abductions	abductions
abducteur	abductor
abductors	abductors
abeam	abeam
abecedarian	abecedarian
abed	abed
aberrance	aberrance
aberrant	aberrant
aberrantly	aberrantly
erreur	feil/mistak
erreur	feil/mistak
aberrations	aberrations
agiter	hjelpe
abetment	abetment
abets	abets
abetted	abetted
abetter	abetter
abetting	abetting
abettor	abettor
abeyance	abeyance
abeyant	abeyant
abominer	abhor
abhorred	abhorred
abomination	abhorrence
abominable	abhorrent
abhorrently	abhorrently
abhorring	abhorring
abhors	abhors
attendre	vente
abided	abided
abides	abides
permanent	abiding
abilities	abilities
capacité	dyktighet
capacité	dyktighet
abiotic	abiotic
lâche	abject
abjection	abjection
abjectly	abjectly
abjuration	abjuration
abjurer	abjure
abjurer	abjurer
ablation	ablation
ablatif	ablative
ardant	ablaze
ardant	ablaze
apte à	dyktig
apte à	dyktig
apte à	dyktig
apte à	dyktig
abler	abler
ablest	ablest
abloom	abloom
ablution	ablution
ablutions	ablutions
ably	ably
agir avec abnégation	abnegate
abnegates	abnegates
abnegation	abnegation
abnormal	abnorm
abnormal	abnorm
abnormal	abnorm
abnormalities	abnormalities
abnormality	abnormality
abnormally	unormalt
aboard	ombord
domicile	abode
abodes	abodes
aboil	aboil
abolir	avskaffe
abolir	avskaffe
abolishable	abolishable
abolished	avskaffet
abolisher	abolisher
abolishes	abolishes
abolishment	abolishment
abolition	abolition
abolition	abolition
abolitionism	abolitionism
abolitionist	abolitionist
abolitionists	abolitionists
abominable	avskyelig
abominably	abominably
abominer	abominate
abomination	abomination
abominations	abominations
aborigène	aboriginal
aboriginally	aboriginally
aborigine	aborigine
aborigines	aborigines
avorter	abort
aborted	aborted
aborter	aborter
aborting	aborting
avortement	abort
avortement	abort
avorteur	abortionist
abortionists	abortionists
abortions	abortions
inutile	abortive
abortively	abortively
aborts	aborts
abonder	abound
concernant	om
au-dessus de	over
aboveboard	aboveboard
aboveground	aboveground
abovementioned	abovementioned
abovementioned	abovementioned
abracadabra	abracadabra
abradable	abradable
abrade	abrade
abrasion	abrasion
abrasions	abrasions
acéré	abrasive
abrasives	abrasives
abreast	abreast
limiter	forminske
abridged	abridged
réduction de texte	abridgement
abridging	abridging
à l'étranger	utenlands
abolir	abrogate
abrogated	abrogated
abolition	abrogation
abrupt	abrupt
abruptement	abruptly
abruptness	abruptness
abcès	byll
abscesses	abscesses
s'enfuir	abscond
absconded	absconded
absence	fravær
absences	absences
absent	fraværende
absentee	absentee
absenteeism	absenteeism
absentees	absentees
absently	absently
absentminded	absentminded
absentmindedly	absentmindedly
absentmindedly	absentmindedly
absentmindedness	absentmindedness
absinthe	absinth
absinthe	absinthe
absolu	absolutt
absolument	absolutt
absolution	absolution
absolutisme	absolutism
absoudre	absolve
absolved	absolved
absolving	absolving
absorber	oppta
absorbability	absorbability
absorbable	absorbable
absorbant	absorbant
absorbed	absorbed
absorbant	absorbent
absorbing	absorbing
absorption	absorption
faire abstinence	abstain
abstained	abstained
sobre	abstemious
abstention	abstention
abstentions	abstentions
abstinence	abstinence
abstinent	abstinent
abstinently	abstinently
abstrait	abstrakt
abstrait	abstrakt
abstraction	abstraction
mystérieux	abstruse
absurde	absurd
absurdism	absurdism
absurdist	absurdist
absurdities	absurdities
absurdité	absurdity
abondance	overflod
abondant	abundant
abondamment	abundantly
insulter	misbruk
abused	abused
abusive	abusive
abusively	abusively
abut	abut
abuzz	abuzz
terrible	abysmal
abysmally	abysmally
abîme	avgrunn
abîme	avgrunn
abysses	abysses
abysses	abysses
acacia	acacia
académique	student
academical	academical
academically	academically
académicien	academician
academies	academies
academism	academism
académie	akademi
acanthe	acanthus
acanthuses	acanthuses
adhérer	accede
adhérer	accede
accélerer	aksellerere
accelerated	accelerated
accélération	acceleration
accelerations	accelerations
accélérateur	gasspedal
accelerators	accelerators
accelerometer	accelerometer
accelerometers	accelerometers
accentuer	aksent
accented	accented
accented	accented
accents	accents
accentual	accentual
accentually	accentually
accentuer	accentuate
accentuated	accentuated
accentuation	accentuation
accepter	akseptere
acceptability	acceptability
acceptable	acceptable
acceptably	acceptably
accueil	acceptance
accepté	accepted
accepter	accepter
accepteur	acceptor
accès	tilgang
accessed	accessed
accessibility	accessibility
sensible	tilgjengelig
acquisition	accession
accessorial	accessorial
accessories	tilbehør
accessorize	accessorize
accessors	accessors
accessoire	accessory
accident	ulykke
accidental	tilfeldig
accidentalism	accidentalism
accidentalist	accidentalist
accidentally	accidentally
accidently	accidently
accidents	ulykker
acclamer	acclaim
acclamation	acclamation
acclimate	acclimate
acclimated	acclimated
acclimatize	tilpasse
accolade	accolade
accolades	accolades
adapter	accommodate
accommodated	accommodated
accommodating	imøtekommende
accomodation	husrom
accommodations	accommodations
accompanied	accompanied
accompanier	accompanier
accompanies	accompanies
accompagnement	accompaniment
accompaniments	accompaniments
cavalier	accompanist
accompanists	accompanists
accompagner	ledsage
accompanyist	accompanyist
accompanyists	accompanyists
accomplice	accomplice
accomplices	accomplices
atteindre	fullende
accomplished	flink
accomplishment	accomplishment
accomplishments	accomplishments
accord	accord
accordance	accordance
accorder	accorder
accorders	accorders
accordéon	trekkspill
accordéoniste	accordionist
accordionists	accordionists
accordions	accordions
accords	accords
accost	accost
compte	konto
accountability	accountability
accountable	ansvarlig
accountant	accountant
accounting	accounting
accouterment	accouterment
accrued	accrued
accruement	accruement
accumulated	samlet
acetaminophen	acetaminophen
acetify	acetify
acetone	acetone
acide	syre
acidic	acidic
allergen	allergen
allergen	allergen
allergic	allergisk
allergies	allergier
allergies	allergier
allergy	allergi
allergy	allergi
alleviate	alleviate
alleviated	lette
ruelle	alle
ruelle	alle
alleys	alleys
alleys	alleys
alliance	allianse
alliance	allianse
alliances	alliances
alliances	alliances
allied	allied
allied	allied
alligator	alligator
alligator	alligator
alligators	alligators
alligators	alligators
alliteration	alliteration
alliteration	alliteration
alliterations	alliterations
alliterations	alliterations
allocate	allocate
allocated	allocated
allocation	allocation
allocation	allocation
allocations	allocations
allocution	allocution
allocution	allocution
allocution	allocution
allot	fordele
laisser	forlate
allowable	allowable
allowance	tilstand
allowed	allowed
alliage	alloy
alphabet	alfabet
alphabetic	alphabetic
alphabetical	alphabetical
alphabetization	alphabetization
alphabetizations	alphabetizations
alphabetize	alphabetize
alphabetized	alphabetized
alphabetizing	alphabetizing
alphabets	alphabets
alphamerical	alphamerical
alphanumeric	alphanumeric
alphanumerical	alphanumerical
alphanumerically	alphanumerically
alphanumerics	alphanumerics
alpine	alpine
alpinism	alpinism
alpinist	alpinist
déjà	allerede
aussi	også
altercation	altercation
altercations	altercations
alterner	svitsje
alternated	alternated
alternately	alternately
entre	blant
amoral	amoral
amorous	amorous
amorously	amorously
amorphous	amorphous
nombre	beløp
nombre	beløp
amp	amp
ampere	ampere
ampersand	ampersand
amphetamine	amphetamine
et	og
anyway	allikevel
quelque part	anywhere
aorta	aorta
apace	raskt
particulier	atskilt
apartheid	apartheid
appartement	leilighet
apathetic	apathetic
apathie	apathy
singe	ape
singe	ape
aperitif	aperitiff
orifice	aperture
apex	spits
aphid	aphid
arriver	ankomme
aspen	aspen
vérifier	audit
auditorium	auditorium
auditoriums	auditoriums
audits	audits
available	disponibel
babble	babble
babbler	babbler
babies	babies
babouin	baboon
bébé	baby
baccalaureate	baccalaureate
baccarat	baccarat
célibataire	bachelor
bachelors	bachelors
bacilli	bacilli
bacillus	basill
dos	tilbake
backache	backache
backbite	backbite
backbone	backbone
arrière-plan	bakgrunn
backgrounds	backgrounds
derrière	backside
backslide	backslide
backup	backup
backward	backward
lard	flesk
bacteria	bacteria
mal	dårlig
insigne	badge
badged	badged
badgers	badgers
badinage	badinage
bag	sekk/veske
bagatelle	bagatelle
bagatelles	bagatelles
colis	bagasje
bags	bags
baguette	baguette
bah	bah
bail	bail
bait	agn
faire cuire au four	bake
boulanger	baker
bakeries	bakeries
bakers	bakers
boulangerie	bakeri
bakeshop	bakeshop
reliquat	balanse
balconies	balconies
balcon	altan/balkon
chauve	skallet
baldhead	baldhead
baldly	baldly
baldness	baldness
bale	bale
baleen	baleen
balk	balk
bal	ball
ballad	ballad
ballade	ballade
ballads	ballads
ballast	ballast
ballet	ballet
balletic	balletic
aérostat	ballong
ballot	ballot
balls	balls
ballyhoo	ballyhoo
beaume	balm
bamboo	bambus
bamboozle	bamboozle
banane	banan
bananas	bananas
bande	band
bandage	bind
bandeau	bandeau
bandit	banditt
bandits	bandits
bandleader	bandleader
bandmaster	bandmaster
bane	bane
banished	banished
barb	barb
barbarian	barbarian
barbarians	barbarians
barbarism	barbarism
coiffeur	barbermester/frisør
barmaid	barmaid
barman	barman
caserne	barracks
plage	strand
faire naître	bjørn
faire naître	bjørn
planche	seng
chambre à coucher	soverom
croire	tror
trahir	forråde
bibliographic	bibliographic
bibliographies	bibliographies
bibliography	bibliography
blackberry	blackberry
livre	bok
boomerang	boomerang
boxer	boxer
garçon	gutt
boys	gutter
cerveau	hjerne
brood	brood
balai	kost
broth	broth
construire	bygge
construction	bygning
adieu	hadet
cab	cab
cabal	cabal
cabala	cabala
cabalism	cabalism
cabalist	cabalist
cabalistic	cabalistic
caballero	caballero
cabaret	kabaret
chou	kål
cabbages	cabbages
cabdriver	cabdriver
cabane	hytte
armoire	cabinet
cabinetmaker	cabinetmaker
cabinetmakers	cabinetmakers
cabinets	cabinets
cabins	cabins
câble	cable
cabled	cabled
cablegram	cablegram
cablegrams	cablegrams
cables	cables
cabling	cabling
cabman	cabman
caboose	caboose
cabotage	cabotage
cabriolet	cabriolet
cabs	cabs
cacao	cacao
cacciatore	cacciatore
cachalot	cachalot
cache	cache
cachepot	cachepot
caches	caches
cackle	cackle
cackled	cackled
cackles	cackles
cackling	cackling
cacophony	cacophony
cacti	cacti
cactus	cactus
cad	cad
cadavre	cadaver
cadaverous	cadaverous
caddies	caddies
caddy	caddy
cadence	cadence
cadet	cadet
cadetship	cadetship
cadge	cadge
cadger	cadger
cafe	cafe
cafes	cafes
cafeteria	cafeteria
cafeterias	cafeterias
caffeine	caffeine
caftan	caftan
cage	bur
cages	cages
cahier	cahier
cairn	cairn
cairns	cairns
caitiff	caitiff
cajole	cajole
cajoler	cajoler
cajolery	cajolery
gâteau	kake
gâteau	kake
calcium	calcium
calculer	beregne
calculated	calculated
calibrate	calibrate
calibrated	calibrated
calibration	calibration
auto	bil
carbonization	carbonization
carbonize	carbonize
carbonized	carbonized
carbonless	carbonless
carburetor	carburetor
carburetors	carburetors
carburization	carburization
carburize	carburize
carte	kort
cardamom	cardamom
cordial	cardiac
cardigan	cardigan
cardioid	cardioid
cardioids	cardioids
avoir soin de	care
avoir soin de	care
cared	cared
career	career
prudent	forsiktig
carefully	carefully
mégère	katt
cachot	cell
cellular	cellular
hasard	anledning
cherries	kirsebær
église	kirke
churches	churches
manteau	kåpe
cloaks	cloaks
horloge	klokke
clockmaker	clockmaker
clockwise	clockwise
cloister	cloister
clone	clone
nuage	sky
clouds	clouds
charbon	kull
ordinateur	pc
computers	computers
comrades	comrades
concealed	concealed
conjuring	conjuring
contempler	contemplate
contempler	contemplate
contempler	contemplate
contemplates	contemplates
contemplation	contemplation
contemplation	contemplation
contemplation	contemplation
contemplations	contemplations
contemplations	contemplations
contemplative	contemplative
contemporaneous	contemporaneous
contemporaneously	contemporaneously
contemporaries	contemporaries
contemporaries	contemporaries
contemporary	contemporary
contemporary	contemporary
contempt	contempt
contempt	contempt
contemptible	avskyelig
contemptibly	contemptibly
contemptuous	contemptuous
contemptuous	contemptuous
contemptuously	contemptuously
contemptuously	contemptuously
contend	contend
contend	contend
contend	contend
contender	contender
contender	contender
contender	contender
contenders	contenders
contenders	contenders
contenders	contenders
contending	contending
contending	contending
contends	contends
contends	contends
content	content
content	content
content	content
content	contented
content	contented
contentedly	contentedly
contentedness	contentedness
contention	contention
contention	contention
contention	contention
contentions	contentions
contentions	contentions
contentions	contentions
contentious	contentious
contentious	contentious
contentment	contentment
contenu	contents
contenu	contents
concours	contest
concours	contest
concours	contest
contestant	contestant
contestant	contestant
cot	cot
coterie	coterie
cotillion	cotillion
cotillon	cotillon
cottage	hytte
cottager	cottager
canapé	divan
tousser	hoste
coughs	coughs
comte	regne
countenance	fjes
counteract	counteract
counterbalance	counterbalance
countermand	countermand
countermarch	countermarch
counterplot	counterplot
counterpoint	counterpoint
counterpoise	counterpoise
counterweight	counterweight
countess	countess
countless	countless
campagne	land
paysan	bonde
countrywide	countrywide
county	county
couple	couple
couplet	couplet
coupon	coupon
courage	mot
courageux	courageous
courageously	courageously
courier	courier
piste	kurs
courser	courser
cour	court
courtois	courteous
courteously	courteously
courteousness	courteousness
courtesy	courtesy
courthouse	courthouse
courtier	courtier
courtliness	courtliness
courtly	courtly
courtmartial	courtmartial
courtroom	courtroom
courtship	courtship
cousine	fetter
cove	cove
covenant	covenant
couvrir	dekk
covert	covert
covet	covet
covetous	covetous
covetously	covetously
vache	ku
vache	ku
peureux	coward
faiblesse	cowardice
cowardly	cowardly
être accroupi	cower
cowherd	cowherd
cowl	cowl
coxcomb	coxcomb
coy	coy
coyly	coyly
coyness	coyness
coyote	coyote
cozily	cozily
cozy	koselig
crabapple	crabapple
crabbed	crabbed
craquer	crack
cracker	cracker
crackle	crackle
cradle	vugge
craft	craft
craftily	craftily
crag	crag
cram	cram
cramp	cramp
cranberry	cranberry
grue	crane
cranium	cranium
crankiness	crankiness
cranky	cranky
crape	crape
crash	krasje
crate	crate
crater	crater
crave	crave
craven	craven
ramper	crawl
écrevisse	crayfish
crayon	crayon
craze	craze
crazily	crazily
fou	gæren
grincer	creak
crème	krem
creamy	creamy
froisser	crease
créer	danne
creation	creation
creator	creator
créature	creature
credence	credence
lettre de créance	credential
credit	kreditt
creditable	creditable
creditably	creditably
creditor	creditor
credo	credo
credulity	credulity
credulous	credulous
credulously	credulously
creed	creed
creek	bekk
ramper	creep
creeps	creeps
cremate	svi
faucher	kutt
cute	cute
cute	cute
cuteness	cuteness
cutoffs	cutoffs
cutout	cutout
cuts	cuts
cutter	cutter
cutting	cutting
cyanate	cyanate
cyanide	cyanide
cybernetic	cybernetic
cybernetician	cybernetician
cybernetics	cybernetics
bécane	syklus
cyclic	cyclic
cyclical	cyclical
cyclist	cyclist
cyclists	cyclists
cycloid	cycloid
cycloidal	cycloidal
cyclone	cyclone
cyclonic	cyclonic
cyclopean	cyclopean
cyclotron	cyclotron
cylindre	sylinder
papa	far
daddies	daddies
papa	daddy
dads	dads
daffy	daffy
daft	daft
dagger	dagger
dahlia	dahlia
dahlias	dahlias
journalier	daily
daintier	daintier
aimable	dainty
dairy	meieri
dalmate	dalmatian
dalmatians	dalmatians
dam	dam
endommager	skade
endommager	skade
endommager	skade
endommager	skade
damaged	damaged
damaged	damaged
damager	damager
damagers	damagers
damages	damages
damaging	damaging
dame	dame
dammit	dammit
damnation	damnation
damned	damned
damp	damp
dampen	dampen
dampened	dampened
dampness	dampness
dams	dams
bal	dans
dancer	dancer
dancers	dancers
dancing	dancing
pissenlit	dandelion
dandelions	dandelions
dandies	dandies
dandruff	dandruff
danger	fare
dangereux	dangerous
dart	dart
jour	dag
point du jour	daybreak
daylight	daylight
days	dager
deactivate	deactivate
deactivation	deactivation
dead	død
sourd	døv
deaths	deaths
profond	dyp
density	density
mériter	deserve
detat	detat
detre	detre
appareil	device
appareil	device
dictated	dictated
dictates	dictates
dictation	dictation
dictations	dictations
dictionaries	orbøker
dictionnaire	ordbok
did	did
décéder	die
died	died
diesel	diesel
diète	diet
dietetically	dietetically
diets	diets
différent	annerledes
difficulties	vanskeligheter
difficulty	difficulty
creuser	dig
digested	digested
dignitaries	dignitaries
dignities	dignities
dignité	dignity
dilate	utvide
dilated	dilated
docteur	lege
doeuvre	doeuvre
chien	hund
doggie	doggie
dogs	dogs
s'enivrer	drikke
drinks	drinks
amener à	kjøre
drizzle	drizzle
sec	tørke
canard	and
chaque	hver
aigle	ørn
eagles	eagles
eaglet	eaglet
oreille	øre
earache	earache
eardrum	eardrum
eardrums	eardrums
earlobe	earlobe
hâtif	tidlig
gagner	oppnå/inntjene
earning	earning
earphones	earphones
earring	dobb
earrings	earrings
ears	ears
butter	jord
earthquake	earthquake
earthquakes	earthquakes
earths	earths
earthworm	earthworm
earthworms	earthworms
earwax	earwax
ease	ease
établi	easel
easier	lettere
easiest	easiest
facilement	easily
easiness	easiness
est	øst
pâques	easter
facile	easy
déjeuner	spise
eatable	eatable
eats	spiser
ebony	ebony
eccentric	eccentric
eccentricity	eccentricity
ecclesiastic	ecclesiastic
écho	ljome
eclipse	eclipse
ecologic	ecologic
ecologist	ecologist
ecology	ecology
economics	economics
ecru	ecru
huit	åtte
dix-huit	atten
eighteenth	attende
eightfold	eightfold
eighth	åttende
eighties	eighties
eightieth	eightieth
eighty	åtti
eightyfold	eightyfold
einsteinium	einsteinium
either	heller
ejaculate	ejaculate
ejaculated	ejaculated
ejaculates	ejaculates
ejaculating	ejaculating
ejaculation	ejaculation
ejaculations	ejaculations
ejaculatory	ejaculatory
eject	eject
ejectable	ejectable
ejecting	ejecting
ejection	ejection
ejector	ejector
ejectors	ejectors
elaborate	elaborate
elaborated	elaborated
elaborates	elaborates
elaborating	elaborating
elaboration	elaboration
elaborations	elaborations
ascenseur	heis
onze	elleve
eleventh	ellevte
eliminate	fjerne
cesser	ende
milieu	miljø
envoy	envoy
envier	envy
envier	envy
escalator	escalator
fonder	etablere
événement	begivenhet
éventuel	eventual
eventually	eventuelt
jadis	noen gang
evergreen	evergreen
infini	everlasting
every	hver
partout	everywhere
eviction	eviction
evidence	evidence
exclaim	exclaim
fable	fable
fables	fables
fabric	fabric
fabricant	fabricant
fabriquer	fabricate
fabricated	fabricated
fabricates	fabricates
fabricating	fabricating
fabrication	fabrication
fabrications	fabrications
fabricator	fabricator
fabricators	fabricators
fabrics	fabrics
fabulist	fabulist
fabulous	fabulous
façade	facade
facades	facades
faceless	faceless
faceplate	faceplate
facet	facet
facetious	facetious
facetious	facetious
facetiously	facetiously
facial	facial
facies	facies
facile	facile
faciliter	facilitate
facilitated	facilitated
facilitates	facilitates
facilitating	facilitating
facilities	facilities
facility	hjelpemiddel
facing	facing
facsimile	facsimile
fact	faktum
parti	faction
factor	factor
factorial	factorial
factorials	factorials
factories	factories
factorization	factorization
factorizations	factorizations
factorize	factorize
factorized	factorized
factors	factors
usine	fabrikk
facts	fakta
factual	factual
facultative	facultative
facultatively	facultatively
faculties	faculties
faculté	evne
fad	fad
pâlir	fade
faded	faded
fader	fader
faders	faders
fading	fading
faery	faery
faience	faience
fail	fail
faible	besvime
faintly	faintly
foire	basar
relativement	temmelig
fée	fairy
fidèle	faithful
faithfully	faithfully
actuel	fashionable
jeûner	fort
fastener	fastener
fastidious	fastidious
épais	tykk
fatal	fatal
fatalism	fatalism
fatality	fatality
fatally	fatally
destination	fate
pêcher	fisk
fishable	fishable
fishbowl	fishbowl
fished	fished
fisher	fisher
fisheries	fisheries
pêcheur	fisherman
fishermen	fishermen
fishers	fishers
fishery	fishery
fishes	fishes
fishing	fishing
fishtail	fishtail
fission	fission
fissionable	fissionable
fissure	fissure
poing	neve
fisted	fisted
fistful	fistful
cinq	fem
fivefold	fivefold
déterminer	fix
fixation	fixation
fixations	fixations
fixity	fixity
fixture	fixture
fixtures	fixtures
fiord	fjord
fjords	fjords
fuite	flytur
floppy	floppy
fluently	fluently
patte	fot
foot	fotball
oublier	glemme
forgetful	forgetful
forgetfulness	forgetfulness
forgivable	forgivable
forgivably	forgivably
excuser	tilgi
forgiveness	tilgivelse
forgives	forgives
forgiving	forgiving
forgo	forgo
forgoes	forgoes
forgotten	forgotten
forlorn	forlorn
formaldehyde	formaldehyde
quatre	fire
renard	rev
fractal	fractal
fractals	fractals
fraction	fraction
fractionate	fractionate
fraternal	fraternal
fraternize	fraternize
amie	venn
amitié	vennskap
fringe	fringe
grenouille	frosk
frogs	frogs
de	fra
front	forside
fucked	fucked
fudge	fudge
fugue	fugue
fulgurant	fulgurant
peureux	funk
funniest	funniest
amusant	morsom
gab	gab
gabardine	gabardine
gabber	gabber
gabbing	gabbing
gaberdine	gaberdine
gadget	gadget
gaiety	gaiety
gaily	gaily
acquisition	oppnå/vinne
gained	gained
gaining	gaining
gala	gala
galactic	galactic
galaxy	galaxy
brave	gallant
gallantly	gallantly
gallantry	gallantry
galleries	galleries
galerie	gallery
gallon	gallon
gallop	gallop
galloped	galloped
galloping	galloping
galvanic	galvanic
galvanism	galvanism
galvanize	galvanize
galvanized	galvanized
jeu	spill
games	games
ail	hvitløk
gaz	gass
essence	bensin
ghostwriter	ghostwriter
don	gave
gifts	gaver
aller	gå
but	mål
goals	goals
chèvre	geit
dieu	gud
goddess	goddess
goddesses	goddesses
parrain	godfather
golfe	golf
golfer	golfer
golfers	golfers
golfs	golfs
bon	godt
bon	godt
adieu	farvel/på gjensyn
goodnight	goodnight
gopher	gopher
robe	kjole
saisir	grab
gradient	gradient
de proche en proche	gradually
grammaire	grammar
raisin	drue
pamplemousse	grapefrukt
habilitated	habilitated
habilitation	habilitation
coutume	bruk
habitant	habitant
habitants	habitants
habitat	habitat
habitation	habitation
habitual	habitual
had	hadde
ouvrier	hånd
guider	hode
heats	heats
ciel	himmel
lourd	tung
hectare	hectare
hectares	hectares
hectoliter	hectoliter
hedgehog	hedgehog
heed	heed
talon	hæl
heeler	heeler
heels	heels
altitude	høyde
held	held
helices	helices
hell	hell
hello	hallo
gouvernail	ratt
helmet	helmet
aider	hjelpe
hemp	hemp
poulet	høne
troupeau	herd
ici	her
héron	heron
hips	hips
battre	treff
hockey	hockey
hogwash	hogwash
holidayer	holidayer
holidays	holidays
domicile	hjem
homeless	homeless
homes	homes
maison	hus
crème glacée	is
instancing	instancing
internship	internship
jab	jab
jabber	jabber
jabberwocky	jabberwocky
jabberwocky	jabberwocky
bambin	jekk
jackal	jackal
jackals	jackals
jackass	jackass
jackdaw	jackdaw
veste	jakke
veste	jakke
jackknife	jackknife
jackpot	jackpot
jade	jade
jaded	jaded
jag	jag
jagged	jagged
prison	fengsel
prison	fengsel
jailbreak	jailbreak
jailed	jailed
jailer	jailer
jailing	jailing
jailor	jailor
jails	jails
jalopy	jalopy
confiture	syltetøy
confiture	syltetøy
jamb	jamb
jammed	jammed
jammed	jammed
jangle	jangle
janitor	janitor
janitor	janitor
jar	jar
jar	jar
jar	jar
jargon	jargon
jasmine	jasmine
jaundice	jaundice
jaunt	jaunt
jaunty	jaunty
javelin	javelin
mâchoire	jaw
gouffre	jaws
jay	jay
jazz	jazz
jazzy	jazzy
jaloux	skinnsyk
envie	jealousy
jeer	jeer
jeer	jeer
jelly	jelly
jellyfish	jellyfish
jeopardize	jeopardize
jeopardize	jeopardize
jerk	jerk
jerk	jerk
jerry	jerry
jersey	jersey
jersey	jersey
plaisanter	jest
jester	jester
jester	jester
jet	jet
jet	jet
jettison	jettison
jetty	jetty
bijou	juvel
jeweler	jeweler
jewelery	jewelery
jewelry	smykke
jewels	jewels
jib	jib
jib	jib
jiffy	jiffy
jig	jig
jigsaw	jigsaw
jihad	jihad
jilt	jilt
tinter	jingle
tinter	jingle
tinter	jingle
jinx	jinx
jitters	jitters
ouvrage	arbeid
ouvrage	arbeid
ouvrage	arbeid
jobless	jobless
jockey	jockey
jocular	jocular
jocund	jocund
jodhpur	jodhpur
jog	jog
jogging	jogging
adhérer	join
adhérer	join
joinable	joinable
joined	joined
joiner	joiner
joinery	joinery
articulation	ledd
articulation	ledd
articulation	ledd
jointly	jointly
plaisanter	spøk
plaisanter	spøk
joked	joked
joker	joker
jokingly	jokingly
jokingly	jokingly
jolly	jolly
jolt	jolt
jolt	jolt
jonquils	jonquils
jostle	jostle
jot	jot
jot	jot
journal	avis
journal	avis
journalism	journalism
journaliste	journalist
journalists	journalists
voyage	reise
voyage	reise
jovial	jovial
jovially	jovially
joie	fryd
joyful	joyful
joyless	joyless
joyously	joyously
jubilee	jubilee
juger	bedømme
juger	bedømme
judged	judged
arrêt	judgement
judicial	judicial
judiciary	judiciary
judo	judo
cruche	krukke/gryte/potte
cruche	krukke/gryte/potte
cruche	krukke/gryte/potte
juggernaut	juggernaut
jongler	juggle
juggler	juggler
jugular	jugular
jus	saft
juiceless	juiceless
juicier	juicier
juiciest	juiciest
juicy	juicy
jukebox	jukebox
jumble	dreie
jumbo	jumbo
sauter	hoppe
jumped	jumped
jumpy	jumpy
junction	junction
junction	junction
jungle	jungle
junior	junior
juniper	juniper
junk	junk
junk	junk
junk	junk
junk	junk
junkers	junkers
junkers	junkers
junkie	junkie
junkie	junkie
junkyard	junkyard
juridic	juridic
jurisdiction	jurisdiction
jurist	jurist
juror	juror
jurors	jurors
jury	jury
juste	kun
justice	justice
justified	berettiget
justify	justify
justly	justly
jut	jut
juvenile	juvenile
juxtapose	juxtapose
kale	kale
kaleidescope	kaleidescope
kaleidoscope	kaleidoscope
kangaroo	kangaroo
karat	karat
karate	karate
kayak	kayak
kebab	kebab
keel	keel
continuer	beholde
keeps	keeps
souvenir	minnesmerke
keg	keg
keg	keg
kennel	kennel
kennel	kennel
kerchief	kerchief
centre	kernel
centre	kernel
centre	kernel
kerosene	kerosene
ketchup	ketchup
chaudron	kjele
touche	nøkkel
touche	nøkkel
touche	nøkkel
keyboard	tastatur
keyhole	keyhole
keying	keying
keynote	keynote
keypad	keypad
khaki	khaki
kick	kick
kick	kick
kickback	kickback
kicked	kicked
kicker	kicker
kickoff	kickoff
kicks	kicks
kid	unge
kid	unge
kid	unge
kiddies	kiddies
kiddies	kiddies
kiddies	kiddies
kidnap	kidnap
kidnaped	kidnaped
kidnaper	kidnaper
kidnaper	kidnaper
kidnapers	kidnapers
kidnaping	kidnaping
kidnapped	kidnapped
kidnapper	kidnapper
kidnappers	kidnappers
kidnapping	kidnapping
kidnappings	kidnappings
rein	nyre
kidneys	kidneys
kidneys	kidneys
kids	unger
kids	unger
rectifier	drepe
rectifier	drepe
killer	killer
killer	killer
killers	killers
killing	killing
killing	killing
killings	killings
killjoy	killjoy
cuisinière	ovn
kilogramme	kilo
kilogram	kilogram
kilohertz	kilohertz
kiloliter	kiloliter
kilomètre	kilometer
kilowatt	kilowatt
kilt	kilt
kin	kin
affable	snill
affable	snill
affable	snill
kindergarten	kindergarten
kindergarten	kindergarten
kindergarten	kindergarten
kindergarten	kindergarten
kindhearted	kindhearted
kindhearted	kindhearted
kindheartedness	kindheartedness
allumer	kindle
allumer	kindle
kindlessly	kindlessly
kindlessly	kindlessly
kindliness	kindliness
kindliness	kindliness
kindly	vennligst
kindly	vennligst
kindly	vennligst
kindly	vennligst
amabilité	kindness
amabilité	kindness
kindred	kindred
kindred	kindred
kinds	venlige
kinds	venlige
roi	konge
royaume	kingdom
royaume	kingdom
kingdoms	kingdoms
martin-pêcheur	kingfisher
kingly	kingly
kings	kings
kinky	kinky
kiosk	kiosk
kipper	kipper
embrasser	kysse
embrasser	kysse
embrasser	kysse
embrasser	kysse
kisses	kisses
kisses	kisses
kit	kit
kit	kit
cuisine	kjøkken
kitchenette	kitchenette
kitchens	kitchens
kitchenware	kitchenware
kitchenware	kitchenware
kite	kite
kith	slektninger
kiting	kiting
kitten	kattunge
kittens	kittens
kitty	kitty
kiwi	kiwi
kiwi	kiwi
kleenex	kleenex
kleenex	kleenex
kleptomania	kleptomania
kleptomaniac	kleptomaniac
knack	knack
knack	knack
sac tyrolien	ryggsekk
pétrir	knead
kneadable	kneadable
kneader	kneader
genou	kne
kneecap	kneecap
s'agenouiller	kneel
s'agenouiller	kneel
kneeling	kneeling
kneeling	kneeling
kneepad	kneepad
knelt	knelt
knelt	knelt
knickers	knickers
knickknack	knickknack
knickknack	knickknack
couteau	kniv
couteau	kniv
knifes	knifes
knifing	knifing
chevalier	knight
chevalier	knight
knighted	knighted
knighthood	knighthood
knightly	knightly
knights	knights
tricoter	strikke
tricoter	strikke
tricoter	strikke
knitted	knitted
knitting	knitting
knitwear	knitwear
knives	knives
knob	knob
knob	knob
knobby	knobby
knobs	knobs
frapper	banke
knockdown	knockdown
knockout	knockout
nouer	knot
knots	knots
knotted	knotted
knotty	knotty
connaître	kjenne
knower	knower
knowhow	knowhow
knowhow	knowhow
knowing	knowing
knowingly	knowingly
knowingly	knowingly
connaissance	kunnskap
connaissance	kunnskap
knowledgeable	knowledgeable
known	kjent
knows	knows
knuckle	knuckle
knuckle	knuckle
knucklebone	knucklebone
knuckles	knuckles
koala	koala
koala	koala
kosher	kosher
kraut	kraut
kraut	kraut
krauts	krauts
kudzu	kudzu
lab	lab
labor	arbeid
ouvrier	arbeider
ouvrier	arbeider
laborers	laborers
dentelle	kniplinger
laceration	laceration
lacerations	lacerations
défaut	lack
lackadaisical	lackadaisical
lackey	lackey
lacking	lacking
lackluster	lackluster
laconic	laconic
laconically	laconically
lacquer	lacquer
lacquer	lacquer
lad	lad
ladies	damer
dame	dame
ladybird	ladybird
ladybug	ladybug
lac	innsjø
lakes	innsjøer
agneau	lam
lambs	lambs
laminated	laminated
laminates	laminates
lampe	lampe
langue	språk
rire	le
cuir	lær
partir	forlate
pupitre	lectern
conférence	forelesning
lecturer	lecturer
ledge	ledge
ledger	ledger
lee	lee
jambe	ben
légitime	legal
legality	legality
legalize	legalisere
legally	legally
legate	legate
legation	legation
legend	legend
legendary	legendary
legion	legion
lettre	brev
lettre	brev
lettre	brev
comme	som
demeurer	leve
aimer	kjærlighet
aimer	kjærlighet
amante	elsker
destinée	luck
lunch	lunsj
ma	ma
ma	ma
maam	maam
maam	maam
maam	maam
macabre	macabre
macabre	macabre
macabrely	macabrely
macadam	macadam
macadam	macadam
macadamize	macadamize
macadamize	macadamize
macadamized	macadamized
macadamized	macadamized
macadamizes	macadamizes
macadamizes	macadamizes
macadamizing	macadamizing
macaque	macaque
macaque	macaque
macaroni	macaroni
macaronies	macaronies
macaroon	macaroon
macaw	macaw
mace	mace
macerate	macerate
macerated	macerated
maceration	maceration
macerations	macerations
maces	maces
machete	machete
machination	machination
machined	machined
machineries	machineries
machinery	machinery
machines	machines
machinist	machinist
machinists	machinists
machismo	machismo
macho	macho
macrocephalic	macrocephalic
macrocosm	macrocosm
macroeconomics	macroeconomics
macroevolution	macroevolution
macroevolutionary	macroevolutionary
macroinstruction	macroinstruction
macromolecular	macromolecular
macromolecule	macromolecule
macromolecules	macromolecules
macropathological	macropathological
macropathology	macropathology
macrophage	macrophage
macrophages	macrophages
macrophagic	macrophagic
macroprocessor	macroprocessor
macroscopic	macroscopic
macrosimulation	macrosimulation
macrostructure	macrostructure
maculate	maculate
maculated	maculated
maculates	maculates
maculation	maculation
maculations	maculations
fou	mad
fou	mad
madame	madam
madams	madams
maddened	maddened
made	laget
made	laget
mademoiselle	mademoiselle
mademoiselles	mademoiselles
maestro	maestro
mafioso	mafioso
gazette	blad
magie	magic
magician	magician
magicians	magicians
magistral	magistral
magistrally	magistrally
magistrature	magistrature
magma	magma
me	meg
mead	mead
prairie	meadow
prairie	meadow
meadowland	meadowland
meadows	meadows
maigre	meager
meagerly	meagerly
meagre	meagre
farine	måltid
meals	meals
moyenne	bety
meander	meander
meaningless	meaningless
meanings	meanings
instrument	midler
viande	kjøtt
meats	meats
meatball	kjøttkake
meatballs	meatballs
mechanical	mechanical
mechanician	mechanician
mechanism	mechanism
mechanisms	mechanisms
médaille	medal
medallion	medallion
medallions	medallions
mediatrice	mediatrice
mediatrix	mediatrix
medic	medic
medical	medical
medically	medically
medicament	medicament
medicaments	medicaments
medicinal	medicinal
remède	medisin
medicines	medicines
medico	medico
medicolegal	medicolegal
medics	medics
medieval	medieval
medievalist	medievalist
medievalists	medievalists
mediocre	middelmådig
mediocrity	mediocrity
méditer	meditere
meditates	meditates
meditation	meditasjon
meditations	meditations
meditative	meditative
medium	mellom
medlar	medlar
medley	medley
medleys	medleys
medulla	medulla
medusae	medusae
meek	meek
meekly	meekly
meekness	meekness
meerschaum	meerschaum
megabyte	megabyte
megabytes	megabytes
megacycle	megacycle
megahertz	megahertz
megalith	megalith
megalithic	megalithic
megalomania	megalomania
megalomaniac	megalomaniac
megalomaniacal	megalomaniacal
megaphone	megaphone
melancholia	melancholia
melancholic	melancholic
melange	melange
melodic	melodic
melodies	melodies
melodious	melodious
melodrama	melodrama
melodramas	melodramas
melodramatic	melodramatic
mélodie	melody
melon	melon
melons	melons
melted	melted
adhérent	member
members	members
membrane	membrane
membranes	membranes
membranous	membranous
memoir	memoir
memoirs	memoirs
memorable	memorable
memories	minner
apprendre par cœur	memorize
memorized	memorized
men	menn
gronder	menace
menagerie	menagerie
menageries	menageries
menhir	menhir
meningitis	meningitis
meniscus	meniscus
menopause	menopause
menstrual	menstrual
menstruation	mens
menstruations	menstruations
intellectuel	mental
mentality	mentality
menthol	menthol
mentionner	nevne
carte	spisekart
meow	meow
meowing	meowing
meows	meows
mephitic	mephitic
mercantile	mercantile
mercantilism	mercantilism
mercenaries	mercenaries
mercenary	mercenary
commerçant	kjøpmann
merchants	merchants
mercure	mercury
compassion	barmhjertighet
meridian	meridian
meridional	meridional
mériter	fortjeneste
meritocracy	meritocracy
merits	merits
mermaid	mermaid
mermaids	mermaids
gai	lystig
message	bud
messages	meldinger
messiahs	messiahs
messianic	messianic
gémir	moan
moaned	moaned
moaning	moaning
moans	moans
moat	moat
moats	moats
mob	mob
se moquer	mock
mocked	mocked
simulacre	mockery
modal	modal
moonlight	moonlight
élan	moose
naïf	naive
naively	naively
nu	bar
nom	navn
named	hete
nameless	nameless
namely	nemlig
namely	nemlig
names	names
national	national
nationalism	nationalism
nationalist	nationalist
inné	native
naturel	natural
naturalize	naturalize
bien sûr	selvfølgelig
neap	neap
près	i nærheten
nearer	nærmere
dédaigner	forsømme
voisin	nabo
neighbors	neighbors
filet	nettverk
networked	networked
networks	networks
neuf	ni
dix-neuf	nitten
nineteenth	nittende
nineties	nineties
ninetieth	ninetieth
ninety	nitti
ninetyfold	ninetyfold
ninth	niende
niobium	niobium
nip	dram
mamelon	nipple
nipples	nipples
nips	nips
nirvana	nirvana
nitrate	nitrate
nitrated	nitrated
nitrates	nitrates
nitrating	nitrating
nitration	nitration
nitrations	nitrations
nitric	nitric
nitride	nitride
azote	nitrogen
nitroglycerin	nitroglycerin
nitroglycerine	nitroglycerine
élevé	adelig
noble	nobleman
noblemen	noblemen
grandeur	nobleness
nul	nobody
noctambulism	noctambulism
noctambulist	noctambulist
nocturn	nocturn
nocturnally	nocturnally
eh bien	nå
actuellement	nowadays
noway	noway
noway	noway
oaf	oaf
oafishness	oafishness
chêne	eik
rame	åre
oarsman	oarsman
oasis	oasis
oat	havre
serment	oath
oatmeal	oatmeal
obdurate	obdurate
obedience	obedience
docile	obedient
obelisk	obelisk
obese	obese
obesity	obesity
océan	hav
on	en
orange	oransje
oranges	appelsiner
orbit	orbit
orbital	orbital
orbits	orbits
orchestre	orkester
orchestral	orchestral
orchestras	orchestras
orchestrated	orchestrated
commander	bestille
ordered	ordered
organism	organism
organisms	organisms
organist	organist
organists	organists
organization	organisasjon
organizations	organisasjoner
organiser	organize
organized	organized
organs	organs
orgasm	orgasm
orgasms	orgasms
orgies	orgies
orgie	orgy
orient	orient
orientable	orientable
orientation	orientation
orientations	orientations
oriented	orientert
orients	orients
orifice	orifice
orifices	orifices
orificial	orificial
origine	begynnelse
inédit	original
originality	originality
originally	originally
originals	originals
origins	origins
ornamental	ornamental
ornithology	ornithology
orthodoxe	orthodox
orthodoxes	orthodoxes
orthogonal	orthogonal
faire les cent pas	tempo
faire les cent pas	tempo
pachyderm	pachyderm
pacifique	pacific
pacifically	pacifically
pacification	pacification
pacifications	pacifications
pacificist	pacificist
pacifier	pacifier
pacifism	pacifism
pacifist	pacifist
pacify	pacify
pacify	pacify
package	package
package	package
packaged	packaged
packaged	packaged
packed	packed
paquet	pakke
packing	packing
pact	pact
pacts	pacts
bloc	pad
padding	padding
barbotter	paddle
paddock	paddock
padlock	padlock
padlock	padlock
padrone	padrone
paella	paella
pagan	pagan
pagans	pagans
pageant	pageant
pageantry	pageantry
paid	betalte
seau	spann
douleur	smerte
pained	pained
pénible	painful
pénible	painful
painfully	painfully
painstaking	painstaking
couleur	male
couleur	male
pinceau	paintbrush
peintre	malerinne
painters	painters
painting	maleri
paints	paints
paire	par
pajamas	pajamas
camarade	pal
camarade	pal
palais	slott
palatable	palatable
palaver	palaver
pâle	blek
palette	palette
pall	pall
pallet	pallet
pallette	pallette
pallor	pallor
paume	palm
paume	palm
palpable	palpable
palpable	palpable
paltry	paltry
brochure	pamphlet
pan	pan
panacea	panacea
panama	panama
pancake	pancake
panda	panda
pandemonium	pandemonium
pane	pane
lambris	panel
paneling	paneling
panelling	panelling
pang	pang
panique	panikk
panique	panikk
panicky	panicky
panorama	panorama
pensée	pansy
pant	pant
panthère	panther
caleçon	underbukse
buffet	pantry
pantalon	bukse
papa	papa
document	dokument/papir
brochure	paperback
parameter	parameter
passer	passer
ardeur	lidenskap
passionately	passionately
passive	passiv
passivity	passivity
password	password
passwords	passwords
passé	forbi
pasta	pasta
pectorals	pectorals
drôle	peculiar
penitence	penitence
penitences	penitences
penitency	penitency
penitent	penitent
pentadactyl	pentadactyl
pentadactylism	pentadactylism
pi	pi
pianist	pianist
pianistic	pianistic
image	bilde
pictures	pictures
pâté	paj
pies	pies
cochon	gris
spécialité	avdeling
pigment	pigment
pigmentation	pigmentation
pigments	pigments
pigs	pigs
pilote	pilot
pilots	pilots
pilule	pilule
pin	furu
ananas	ananas
pineapples	pineapples
pines	pines
pink	rosa
poche	lomme
pocketbook	pocketbook
pocketbooks	pocketbooks
pockets	pockets
estrade	podium
pogrom	pogrom
pogroms	pogroms
pointer	pointer
pointillism	pointillism
pointillist	pointillist
pointilliste	pointilliste
pointillistic	pointillistic
poison	gift
poisonous	poisonous
poisonousness	poisonousness
poisons	poisons
polar	polar
polarities	polarities
polarity	polarity
polarize	polarize
polarized	polarized
polemical	polemical
polemically	polemically
polemicize	polemicize
police	politi
agent	politikonstabel
agent	politikonstabel
agent	politikonstabel
policemen	policemen
policemen	policemen
policemen	policemen
policewoman	policewoman
policewomen	policewomen
politique	politikk
polonais	polish
polonais	polish
courtois	polite
politely	politely
politesse	politeness
political	political
politically	politically
politician	politikere
politicians	politicians
politique	politikk
polka	polka
pollutant	pollutant
pollute	pollute
polluted	polluted
polluter	polluter
pollution	pollution
polonium	polonium
poltergeist	poltergeist
polyandrous	polyandrous
polyandry	polyandry
verser	pour
pout	furte
poverty	poverty
poudre	pudder/pulver
powdery	powdery
puissance	power
puissant	sterk
powerless	powerless
powwow	powwow
practicability	practicability
practicable	gjennomførbar
réel	practical
prier	pray
prière	bønn
prayers	prayers
praying	praying
praying	praying
prêcher	preach
prêcher	preach
preacher	preacher
preacher	preacher
preachers	preachers
preachers	preachers
preaches	preaches
preaches	preaches
preachify	preachify
preaching	preaching
preaching	preaching
preaching	preaching
preachy	preachy
preachy	preachy
preamplifiers	preamplifiers
prearrange	prearrange
prearrange	prearrange
prince	prins
princedom	princedom
princely	princely
princes	princes
princesse	prinsesse
principal	overlærer
principal	overlærer
principalities	principalities
principality	principality
principalement	principally
principalement	principally
principals	principals
principe	principle
principles	principles
impression	avtrykk
impression	avtrykk
impression	avtrykk
printed	printed
imprimeur	printer
imprimeur	printer
priorities	priorities
priorities	priorities
priority	priority
démontrer	bevise
pouls	puls
pulverizable	pulverizable
pulverizables	pulverizables
pulverization	pulverization
moudre	pulverize
pulverized	pulverized
pulverizer	pulverizer
pulverizers	pulverizers
pulverizes	pulverizes
pulverizing	pulverizing
puma	puma
pomper	pumpe
pousser	trykk
pushchair	pushchair
pushing	pushing
appliquer	put
putdown	putdown
putout	putout
putrefaction	putrefaction
quail	quail
quails	quails
quake	quake
propriété	kvalitet
qualm	qualm
qualms	qualms
quantité	antall
se disputer	krangel
quarry	quarry
quartier	kvarter
quarterdeck	quarterdeck
quarterfinal	quarterfinal
queen	dronning
queer	queer
étouffer	quell
quench	quench
querulous	querulous
query	query
recherche	quest
question	spørsmål
queue	queue
chicaner	quibble
prompt	fort
quicklime	quicklime
rapidement	kvikk
quicksand	quicksand
quicksilver	quicksilver
calme	quiet
quieten	quieten
paisiblement	quietly
quill	quill
coudre	quilt
quirk	quirk
démissioner	quit
bien	nokså
quota	quota
citation	quotation
citer	quote
r	r
rabbet	rabbet
rabbin	rabbi
rabbinic	rabbinic
lapin	kanin
rabbits	rabbits
rabble	rabble
rabid	rabid
rage	rabies
raton laveur	raccoon
s'élancer	race
racehorse	racehorse
racemic	racemic
racer	racer
races	races
rachis	rachis
rachitic	rachitic
rachitis	rachitis
racialism	racialism
racialist	racialist
racialistic	racialistic
racing	racing
racism	racism
racist	racist
rack	rack
racket	racket
racket	racket
radar	radar
radars	radars
radio	radio
lire	lese
readability	readability
readable	readable
lecteur	reader
readers	readers
readership	readership
readership	readership
readily	readily
readily	readily
readily	readily
readiness	readiness
readiness	readiness
reading	leser
reading	leser
reading	leser
readings	readings
readings	readings
readjust	readjust
readjusts	readjusts
readjusts	readjusts
readout	readout
readout	readout
readouts	readouts
reads	reads
prêt	klar
prêt	klar
prêt	klar
reaffirm	reaffirm
reaffirm	reaffirm
reaffirms	reaffirms
reaffirms	reaffirms
reagent	reagent
effectif	virkelig
effectif	virkelig
effectif	virkelig
realisable	realisable
realism	realism
realist	realist
realistic	nøkternt
realistic	nøkternt
realistically	realistically
réalité	virkelighet
comprendre	forstå
en réalité	virkelig
reporter	reporter
représenter	representerer
demander	anmode
demander	anmode
demander	anmode
chemin	vei
roads	roads
roadwork	roadwork
ravisseur	robber
rotting	rotting
sabbat	sabbat
sabbath	sabbath
sabbatic	sabbatic
sabbatical	sabbatical
saber	saber
sabin	sabin
sable	sable
sabot	sabot
sabotage	sabotage
sabotaged	sabotaged
sabotages	sabotages
saboteur	saboteur
sabra	sabra
sabras	sabras
saccade	saccade
saccharin	saccharin
saccharine	saccharine
saccharose	saccharose
sacerdotal	sacerdotal
sacerdotally	sacerdotally
sachet	sachet
licencier	sekk/veske
licencier	sekk/veske
sackcloth	sackcloth
sacked	sacked
sackful	sackful
sacks	sacks
sacrament	sacrament
sacramental	sacramental
sacraments	sacraments
sacre	sacre
sacré	sacred
consacrer	sacrifice
sacrificed	sacrificed
sacrifices	sacrifices
sacrilege	sacrilege
affligé	bedrøvelig
sadden	sadden
sadder	sadder
saddest	saddest
selle	sal
saddlebag	saddlebag
saddlebags	saddlebags
saddlebow	saddlebow
saddlecloth	saddlecloth
saddled	saddled
saddleless	saddleless
saddler	saddler
saddlery	saddlery
saddles	saddles
saddletree	saddletree
sadism	sadism
sadist	sadist
sadistic	sadistic
sadistically	sadistically
sadists	sadists
sadly	sadly
affliction	tristhet
safari	safari
à l'abri	sikker
safecracker	safecracker
safecracking	safecracking
safeguard	safeguard
safeguarded	safeguarded
safeguards	safeguards
safer	sikrere
safest	sikreste
sécurité	trygghet
safflower	safflower
saffron	saffron
sag	sag
saga	saga
intelligent	sagacious
sagaciously	sagaciously
sagaciousness	sagaciousness
sagacity	sagacity
sauge	sage
sagely	sagely
sago	sago
saguaro	saguaro
sahib	sahib
said	sa
voile	sail
voile	sail
sailable	sailable
sailboat	sailboat
sailboater	sailboater
sailcloth	sailcloth
sailors	sailors
sails	sails
sainfoin	sainfoin
saint	saint
sainted	sainted
sainthood	sainthood
saith	saith
sake	skyld
salability	salability
salacious	salacious
salade	salad
salads	salads
salamander	salamander
salaried	salaried
salaries	salaries
sale	salg
saleable	saleable
saleroom	saleroom
salesclerk	salesclerk
salesgirl	salesgirl
saleslady	saleslady
marchand	salesman
salesmanship	salesmanship
salesmen	salesmen
salespeople	salespeople
salesperson	salesperson
salesroom	salesroom
saleswoman	saleswoman
saleswomen	saleswomen
salient	salient
saline	saline
salinity	salinity
salinometer	salinometer
salinometers	salinometers
salive	saliva
salivary	salivary
salivate	salivate
salivated	salivated
salivates	salivates
salivating	salivating
salivation	salivation
sallies	sallies
pâle	blek
sallowish	sallowish
saumon	laks
salmons	salmons
salon	sal
salons	salons
saler	salt
saltwater	saltwater
saltworks	saltworks
saltwort	saltwort
salty	salty
salubrious	salubrious
salubrity	salubrity
salut	salvage
salver	salver
samba	samba
identique	samme
sampan	sampan
samphire	samphire
samurai	samurai
samurais	samurais
sable	sand
sandale	sandal
école	skole
mer	sjø
vendre	selge
seller	seller
sellers	sellers
serendipity	serendipity
serein	serene
36770	sju
sevenfold	sevenfold
dix-sept	sytten
seventeenth	søttende
seventh	sjuende
seventies	seventies
seventieth	seventieth
seventy	sytti
seventyfold	seventyfold
sever	sever
sévère	severe
severed	severed
severely	severely
severities	severities
severity	severity
sewage	sewage
sexe	sex
sexagenarian	sexagenarian
sexual	sexual
sexually	sexually
shades	shades
ombre	shadow
shadows	shadows
shagreen	shagreen
schah	shah
secouer	shake
shakedown	shakedown
shaken	shaken
shaky	shaky
shaman	shaman
shamanism	shamanism
shampoo	shampoo
shampoos	shampoos
mouton	sau
sheepherder	sheepherder
expédier	skip
expédier	skip
shit	drit
malade	syk
argent	sølv
chanter	synge
chanteuse	singer
forer	vask
six	seks
seize	seksten
sixteenth	sekstende
sixties	sixties
soixante	seksti
sixtyfold	sixtyfold
ampleur	størrelse
patin	skate
skateboard	skateboard
skateboarder	skateboarder
skateboarding	skateboarding
skateboards	skateboards
skater	skater
skaters	skaters
skates	skates
skating	skating
adresse	skill
skilled	skilled
skilless	skilless
adroit	skillful
ciel	himmel
skylark	skylark
skyscraper	skyscraper
snout	snout
neiger	snø
snowball	snowball
flocon de neige	snowflake
snowman	snowman
snowstorm	snowstorm
software	programvare
sorrily	sorrily
sorrow	sorg
sorte	sortere
sorted	sorted
sorter	sorter
âme	sjel
spectra	spectra
spectrum	spectrum
speculate	speculate
speculation	speculation
parenthèse	staple
stapled	stapled
stapler	stapler
staplers	staplers
staples	staples
étoile	stjerne
stars	stars
activer	begynne
stifled	stifled
force	kraft
sot	dum
sujet	subject
arriver	succeed
prospérité	fremgang
soleil	sol
sunbathe	sunbathe
sunny	sunny
suppressed	suppressed
soupçonner	suspect
blasphémer	banne
tab	tab
tab	tab
tabernacle	tabernacle
liste	bord
tableau	tableau
tableaus	tableaus
tableaux	tableaux
tablecloth	tablecloth
tablecloths	tablecloths
tables	tables
liste	tablet
tablets	tablets
taboos	taboos
tachometer	tachometer
tachometers	tachometers
tacit	tacit
queue	hale
couturière	skredder
tailored	tailored
tailors	tailors
habit	tails
devoir	task
tasks	tasks
goût	smak
tasted	tasted
tasteless	tasteless
larme	tear
larme	tear
larme	tear
larme	tear
teardrop	teardrop
tearful	tearful
tearfully	tearfully
tearfully	tearfully
teargas	teargas
tearjerker	tearjerker
tearless	tearless
tearless	tearless
tearoom	tearoom
tears	tears
tears	tears
tearstained	tearstained
tearstained	tearstained
agacer	tease
agacer	tease
agacer	tease
teasel	teasel
teaser	teaser
teaser	teaser
teases	teases
teases	teases
teases	teases
teasing	teasing
teasing	teasing
teasingly	teasingly
teasingly	teasingly
teaspoon	teaspoon
teaspoon	teaspoon
teaspoonful	teaspoonful
mamelle	teat
mamelle	teat
mamelle	teat
mamelle	teat
teatime	teatime
teats	teats
teats	teats
dix	ti
tendencies	tendencies
aptitude	tendens
tenderfoot	tenderfoot
tenderly	tenderly
thence	thence
thence	thence
thenceforth	thenceforth
thenceforward	thenceforward
theocracy	theocracy
theocratic	theocratic
theodolite	theodolite
theologian	theologian
theologians	theologians
theological	theological
theologically	theologically
theology	theology
theorem	theorem
theorems	theorems
theoretical	theoretical
theoretical	theoretical
theoretically	theoretically
theoretician	theoretician
theoretician	theoretician
theoreticians	theoreticians
theoreticians	theoreticians
theorist	theorist
theorist	theorist
theorists	theorists
theorists	theorists
theorize	theorize
thief	tyv
quoique	though
quoique	though
pensée	tanke
pensée	tanke
thoughtful	omtenksomt
thoughtfully	thoughtfully
précaution	thoughtfulness
thoughtless	thoughtless
thoughtlessly	thoughtlessly
thoughtlessness	thoughtlessness
mille	tusen
thousandth	thousandth
thrash	thrash
thrash	thrash
fil	tråd
fil	tråd
fil	tråd
threadbare	threadbare
menace	threat
gronder	threaten
sinistre	threatening
threateningly	threateningly
trois	tre
tigress	tigress
aujourd'hui	i dag
doigt du pied	tå
tradition	tradition
traditional	tradisjonell
trail	trail
clique	tog
trainee	trainee
trainer	trainer
traitor	traitor
transaction	transaksjon
transalpine	transalpine
transcribe	transcribe
passer	overføring
traduire	oversette
translation	oversettelse
translator	translator
adresser	sende
arbre	tre
camiono	lastebil
deux	to
ubiquitous	ubiquitous
ubiquity	ubiquity
pis	udder
ugh	æsj
uglier	uglier
ugliest	ugliest
uglify	uglify
uglily	uglily
ugliness	ugliness
laid	heslig
ukulele	ukulele
ulcère	ulcer
ulcerate	ulcerate
ulcerated	ulcerated
ulceration	ulceration
ulcerative	ulcerative
ulna	ulna
ultimo	ultimo
unemployment	arbeidsløshet
vacant	ledig
vacate	vacate
vacances	ferie
vacciner	vaccinate
vaccinated	vaccinated
vacuum	vacuum
vacuumed	vacuumed
vagin	vagina
vagrant	vagrant
vague	vague
vain	vain
wacky	wacky
wag	wag
noix	walnut
warehouse	varehus
warehouse	varehus
warehouses	warehouses
laver	vaske
pleurer	weep
weeping	weeping
weeping	weeping
weeps	weeps
weepy	weepy
weepy	weepy
weevil	weevil
weft	weft
peser	weigh
peser	weigh
weighing	weighing
weighings	weighings
weighs	veier
poids	vekt
weighted	weighted
weighted	weighted
weightily	weightily
weighting	weighting
weighting	weighting
weightless	weightless
weightlessness	weightlessness
weights	weights
weights	weights
weighty	weighty
weighty	weighty
weir	weir
bizarre	merkelig
weirdie	weirdie
weirdies	weirdies
weirdly	weirdly
weirdness	weirdness
weirdness	weirdness
weirdo	weirdo
weirdos	weirdos
weirs	weirs
recevoir solennellement	velkommen
recevoir solennellement	velkommen
recevoir solennellement	velkommen
recevoir solennellement	velkommen
où	hvor
fenêtre	vindu
fenêtre	vindu
windowpane	windowpane
windowpanes	windowpanes
windows	windows
windstorm	windstorm
vin	vin
wineglass	wineglass
winegrower	winegrower
winemaker	winemaker
winemaking	winemaking
winepress	winepress
wines	wines
winey	winey
aile	vinge
winglet	winglet
wink	wink
hiver	vinter
effacer	wipe
fil	ståltråd
fil	ståltråd
fil	ståltråd
wired	wired
radio	wireless
wiring	wiring
wiry	wiry
intelligence	visdom
raisonnable	vis
wisecrack	wisecrack
wisely	wisely
wiser	wiser
désirer	ønske
désirer	ønske
wishbone	wishbone
wishes	wishes
wishful	wishful
witch	heks
witches	witches
à	med
décéder	withdraw
décéder	withdraw
sans	uten
témoin	witness
témoin	witness
witnesses	witnesses
wolverine	wolverine
wolverine	wolverine
monde	verden
worldwide	worldwide
xenophobe	xenophobe
xenophobia	xenophobia
xenophobic	xenophobic
xerographic	xerographic
xylem	xylem
xylene	xylene
xylophone	xylophone
xylophones	xylophones
xylophonist	xylophonist
xylose	xylose
xylotomic	xylotomic
yacht	yacht
yachting	seiling
yachtsman	yachtsman
yak	yak
igname	yam
yap	yap
cour	tun
yardstick	yardstick
yarn	yarn
bâiller	yawn
bâiller	yawn
yawning	yawning
yeah	yeah
an	år
yearbook	yearbook
yearlong	yearlong
annuellement	yearly
annuellement	yearly
aspirer	yearn
yearning	yearning
yearningly	yearningly
years	years
yeast	yeast
yell	yell
yell	yell
jaune	gul
yellowed	yellowed
yellowing	yellowing
yellowish	yellowish
bien	ja
hier	igår
encore	ennå
yew	yew
abandonner	yield
yoga	yoga
yaourt	yoghurt
yogurt	yogurt
yoke	åk
yolk	yolk
te	du/deg/ni
te	du/deg/ni
jeune	ung
younger	yngre
youngster	youngster
youth	ungdom
youthful	youthful
yuppie	yuppie
zabaglione	zabaglione
zany	zany
zazen	zazen
ferveur	iver
fervent	zealous
zèbre	zebra
zenith	zenith
zero	null
zero	null
vigueur	zest
zigzag	zigzag
zinc	zinc
fermeture éclair	glidelås
zodiac	zodiac
zodiac	zodiac
zone	sone
zone	sone
zoo	dyrehave
zoology	zoology
zoom	zoom
zucchini	zucchini
