à	en/ett
à	en/ett
aardvark	jordsvin
aardvark	jordsvin
aardvarks	aardvarks
aback	bakåt
aback	bakåt
aback	bakåt
abacterial	abacterial
abaque	kulram
abaque	kulram
abaque	kulram
abacuses	abacuses
abacuses	abacuses
abacuses	abacuses
abaft	akter ut
abalone	abalone
abalones	abalones
abandonner	överge
abandonner	överge
immoral	övergiven/övergivna
immoral	övergiven/övergivna
immoral	övergiven/övergivna
abandonee	abandonee
abandoner	abandoner
abandoning	abandoning
abandonment	uppgivenhet
abandonment	uppgivenhet
abandonments	abandonments
humilier	förnedra
abased	abased
abasement	förnedring
abasements	abasements
abases	abases
abash	göra generad
abashed	generad
abashed	generad
abasing	abasing
diminuer	minska/lindra
diminuer	minska/lindra
abated	abated
rabais	avtagande
rabais	avtagande
abatements	abatements
abates	abates
abating	abating
abating	abating
boucherie	slakthus
abbe	abbe
abberations	abberations
abbaye	kloster
abbaye	kloster
abbeys	abbeys
abbé	abbot
abbé	abbot
abbé	abbot
abbé	abbot
abbé	abbot
abbots	abbotar
raccourcir	förkorta
raccourcir	förkorta
abbreviated	abbreviated
abbreviates	abbreviates
abbreviating	abbreviating
abbreviation	förkortning
abbreviation	förkortning
abbreviation	förkortning
abbreviations	förkortningar
abbreviations	förkortningar
abbreviator	abbreviator
abdicable	abdicable
abdiquer	avsäga sig
abdiquer	avsäga sig
abdicated	abdicated
abdication	avsägelse
abdicator	abdicator
abdomen	kropp
abdomen	kropp
abdomens	abdomens
abdominal	buk-
abdominally	abdominally
abduct	bortföra
abducted	abducted
abducting	abducting
abduction	bortrövande
abductions	abductions
abducteur	kidnappare
abductors	abductors
abeam	tvärs
abecedarian	alfabetisk
abed	till sängs
aberrance	avvikelse
aberrant	som far vilse
aberrantly	aberrantly
erreur	villfarelse
erreur	villfarelse
aberrations	aberrations
agiter	underblåsa
abetment	medhjälp
abets	abets
abetted	abetted
abetter	abetter
abetting	abetting
abettor	medhjälpare
abeyance	vila
abeyant	abeyant
abominer	avsky
abhorred	abhorred
abomination	avsky
abominable	motbjudande
abhorrently	abhorrently
abhorring	abhorring
abhors	abhors
attendre	stanna/vänta
abided	abided
abides	abides
permanent	bestående/varaktig
abilities	själsgåvor
capacité	möjlighet
capacité	möjlighet
abiotic	abiotic
lâche	föraktlig
abjection	uselhet
abjectly	abjectly
abjuration	avsvärjande
abjurer	avsvärja
abjurer	abjurer
ablation	borttagande
ablatif	ablativ
ardant	i lågor
ardant	i lågor
apte à	kunna
apte à	kunna
apte à	kunna
apte à	kunna
abler	abler
ablest	ablest
abloom	i blom
ablution	tvätta sig
ablutions	tvagning
ably	skicklig/duktigt/kunnigt
agir avec abnégation	avsäga sig
abnegates	abnegates
abnegation	förnekelse
abnormal	avvikande
abnormal	avvikande
abnormal	avvikande
abnormalities	abnormalities
abnormality	abnormitet
abnormally	onormalt
aboard	ombord
domicile	boning/vistelse
abodes	abodes
aboil	kokande
abolir	avskaffa
abolir	avskaffa
abolishable	abolishable
abolished	avskaffade
abolisher	abolisher
abolishes	abolishes
abolishment	abolishment
abolition	avskaffande
abolition	avskaffande
abolitionism	abolitionism
abolitionist	förkämpe
abolitionists	abolitionists
abominable	avskyvärd
abominably	abominably
abominer	avsky
abomination	avsky
abominations	abominations
aborigène	urinvånare
aboriginally	aboriginally
aborigine	urinvånare
aborigines	aborigines
avorter	abort
aborted	avbrutits
aborter	aborter
aborting	aborting
avortement	missfall/abort
avortement	missfall/abort
avorteur	abortör
abortionists	abortionists
abortions	abortions
inutile	misslyckad
abortively	abortively
aborts	aborts
abonder	överflöda av
concernant	om/cirka
au-dessus de	ovan
aboveboard	aboveboard
aboveground	aboveground
abovementioned	abovementioned
abovementioned	abovementioned
abracadabra	abrakadabra
abradable	abradable
abrade	skava av
abrasion	avskavning/slitning
abrasions	abrasions
acéré	sträv
abrasives	abrasives
abreast	jämsides
limiter	förkorta
abridged	abridged
réduction de texte	förkortning/sammandrag
abridging	abridging
à l'étranger	utomlands
abolir	avskaffa
abrogated	abrogated
abolition	abrogation
abrupt	hastig
abruptement	abrupt
abruptness	abruptness
abcès	böld
abscesses	abscesses
s'enfuir	rymma
absconded	absconded
absence	frånvaro
absences	absences
absent	frånvarande
absentee	frånvarande
absenteeism	skolk
absentees	absentees
absently	frånvarande
absentminded	absentminded
absentmindedly	absentmindedly
absentmindedly	absentmindedly
absentmindedness	absentmindedness
absinthe	absinth
absinthe	absinthe
absolu	absolut
absolument	absolut
absolution	frikännande
absolutisme	envälde
absoudre	frikänna
absolved	absolved
absolving	absolving
absorber	uppta
absorbability	absorbability
absorbable	absorbable
absorbant	absorbant
absorbed	ingick i
absorbant	absorberande
absorbing	absorberande
absorption	absorbering
faire abstinence	avstå
abstained	abstained
sobre	återhållsam
abstention	röstnedläggelse
abstentions	abstentions
abstinence	röstnedläggelse/återhållsamhet
abstinent	måttlig
abstinently	abstinently
abstrait	abstrakt
abstrait	abstrakt
abstraction	abstraktion
mystérieux	dunkel
absurde	orimlig
absurdism	absurdism
absurdist	absurdist
absurdities	absurdities
absurdité	orimlighet
abondance	överflöd
abondant	överflödande
abondamment	abundantly
insulter	missbruk
abused	missbrukat
abusive	ovettig/smädlig
abusively	abusively
abut	gränsa intill
abuzz	abuzz
terrible	bottenlös
abysmally	abysmally
abîme	avgrund
abîme	avgrund
abysses	abysses
abysses	abysses
acacia	akacia
académique	akademisk
academical	akademisk
academically	akademiskt
académicien	akademimedlem
academies	academies
academism	academism
académie	akademi
acanthe	acanthus
acanthuses	acanthuses
adhérer	tillträda/biträda
adhérer	tillträda/biträda
accélerer	accelerera
accelerated	accelererade
accélération	acceleration
accelerations	accelerations
accélérateur	gaspedal
accelerators	accelerators
accelerometer	accelerometer
accelerometers	accelerometers
accentuer	tonvikt
accented	betonade
accented	betonade
accents	accents
accentual	accentual
accentually	accentually
accentuer	betona
accentuated	accentuated
accentuation	betoning
accepter	acceptera
acceptability	godtagbarhet
acceptable	godtagbart
acceptably	acceptabelt
accueil	accepterande
accepté	accepterad
accepter	accepter
accepteur	acceptant
accès	tillgång
accessed	åtkomliga
accessibility	accessibility
sensible	åtkomlig
acquisition	tillträde/tillskott
accessorial	accessorial
accessories	tillbehör
accessorize	accessorize
accessors	accessors
accessoire	tillbehör
accident	olycka
accidental	tillfällig
accidentalism	accidentalism
accidentalist	accidentalist
accidentally	händelsevis
accidently	accidently
accidents	olyckor
acclamer	hylla/hälsa såsom
acclamation	bifallsrop
acclimate	acclimate
acclimated	acclimated
acclimatize	anpassa
accolade	dubbning till riddare
accolades	accolades
adapter	anpassa
accommodated	anpassad
accommodating	tillmötesgående
accomodation	anpassning
accommodations	accommodations
accompanied	accompanied
accompanier	accompanier
accompanies	accompanies
accompagnement	ackompanjemang
accompaniments	accompaniments
cavalier	ackompanjatör
accompanists	accompanists
accompagner	ackompanjera
accompanyist	accompanyist
accompanyists	accompanyists
accomplice	medbrottsling
accomplices	accomplices
atteindre	utföra
accomplished	presterade
accomplishment	prestation
accomplishments	accomplishments
accord	bevilja/medge
accordance	enlighet
accorder	accorder
accorders	accorders
accordéon	dragspel
accordéoniste	accordionist
accordionists	accordionists
accordions	accordions
accords	accords
accost	tilltala
compte	beräkning
accountability	ansvarighet
accountable	ansvarig/förklarlig
accountant	bokförare
accounting	bokföring
accouterment	accouterment
accrued	accrued
accruement	accruement
accumulated	samlat
acetaminophen	acetaminophen
acetify	acetify
acetone	aceton
acide	sur
acidic	acidic
allergen	allergen
allergen	allergen
allergic	allergisk
allergies	allergier
allergies	allergier
allergy	allergi
allergy	allergi
alleviate	mildra
alleviated	lätta
ruelle	gränd
ruelle	gränd
alleys	alleys
alleys	alleys
alliance	förbindelse
alliance	förbindelse
alliances	alliances
alliances	alliances
allied	allierad
allied	allierad
alligator	alligator
alligator	alligator
alligators	alligators
alligators	alligators
alliteration	alliteration
alliteration	alliteration
alliterations	alliterations
alliterations	alliterations
allocate	tilldela
allocated	tilldelat
allocation	tilldelning
allocation	tilldelning
allocations	tilldelningen
allocution	allocution
allocution	allocution
allocution	allocution
allot	fördela
laisser	tillåta
allowable	tillåtna
allowance	tillstånd
allowed	tillåten
alliage	legering
alphabet	alfabete
alphabetic	alfabetisk
alphabetical	alfabetisk
alphabetization	alphabetization
alphabetizations	alphabetizations
alphabetize	alphabetize
alphabetized	alphabetized
alphabetizing	alphabetizing
alphabets	alfabeten
alphamerical	alphamerical
alphanumeric	alfanumerisk
alphanumerical	alphanumerical
alphanumerically	alphanumerically
alphanumerics	alphanumerics
alpine	alpin
alpinism	alpinism
alpinist	alpinist
déjà	redan
aussi	även
altercation	gräl
altercations	altercations
alterner	växla
alternated	alternated
alternately	alternativt
entre	bland
amoral	amoralisk
amorous	kärleksfull
amorously	amorously
amorphous	formlös
nombre	summa
nombre	summa
amp	ampere
ampere	ampere
ampersand	ampersand
amphetamine	amfetamin
et	och
anyway	hursomhelst
quelque part	varsomhelst
aorta	aorta
apace	snabbt
particulier	isär
apartheid	apartheid
appartement	lägenhet
apathetic	apatisk
apathie	apati
singe	människoapa
singe	människoapa
aperitif	aperitif
orifice	öppning
apex	spets
aphid	aphid
arriver	anländer
aspen	aspen
vérifier	granska/revidera
auditorium	mötessal
auditoriums	auditoriums
audits	audits
available	tillgänglig
babble	pladdra/sorl
babbler	pratmakare
babies	babies
babouin	babian
bébé	barn
baccalaureate	kandidatexamen
baccarat	baccarat
célibataire	ungkarl
bachelors	ungkarlar
bacilli	bacilli
bacillus	bacill
dos	tillbaka
backache	ryggsmärtor
backbite	baktala
backbone	ryggrad
arrière-plan	bakgrund
backgrounds	backgrounds
derrière	bak
backslide	återfalla
backup	ta kopia
backward	bakåt
lard	sidfläsk
bacteria	bakterie
mal	dålig
insigne	emblem
badged	badged
badgers	badgers
badinage	raljeri
bag	väska
bagatelle	bagatell
bagatelles	bagatelles
colis	bagage
bags	påsar
baguette	list
bah	bah
bail	borgen
bait	agn
faire cuire au four	baka
boulanger	bagare
bakeries	bakeries
bakers	bakers
boulangerie	bageri
bakeshop	bakeshop
reliquat	balans
balconies	balconies
balcon	balkong
chauve	skallig/kal
baldhead	baldhead
baldly	rakt på sak
baldness	skallighet
bale	bal/packe
baleen	valfiskben
balk	hindra
bal	boll/kula
ballad	visa
ballade	ballad
ballads	ballader
ballast	barlast
ballet	balett
balletic	balletic
aérostat	ballong
ballot	valsedel/sluten omröstning
balls	ballar/bollar
ballyhoo	ballyhoo
beaume	balsam
bamboo	bambu
bamboozle	lura
banane	banan
bananas	bananas
bande	musikkår
bandage	bandage
bandeau	hårband
bandit	bandit
bandits	bandits
bandleader	bandleader
bandmaster	kapellmästare
bane	fördärv
banished	fördriven
barb	hulling
barbarian	barbar
barbarians	barbarer
barbarism	barbarismen
coiffeur	frisör
barmaid	barflicka
barman	bartender
caserne	kaserner
plage	stranden
faire naître	bära
faire naître	bära
planche	säng
chambre à coucher	sovrum
croire	tro
trahir	förråda
bibliographic	bibliographic
bibliographies	bibliografier
bibliography	källförteckning
blackberry	björnbär
livre	bok
boomerang	boomerang
boxer	boxer
garçon	pojke
boys	pojkar
cerveau	hjärna
brood	kull/yngel/ruva/grubbla
balai	kvast/ginst
broth	buljong/köttsoppa
construire	bygga
construction	byggnad
adieu	hejdå
cab	droska/förarhytt
cabal	kabal
cabala	cabala
cabalism	cabalism
cabalist	cabalist
cabalistic	cabalistic
caballero	caballero
cabaret	krog
chou	kål
cabbages	cabbages
cabdriver	cabdriver
cabane	hytt
armoire	skåp/kabinett
cabinetmaker	cabinetmaker
cabinetmakers	cabinetmakers
cabinets	cabinets
cabins	hytter
câble	kabel
cabled	cabled
cablegram	cablegram
cablegrams	cablegrams
cables	kablar
cabling	cabling
cabman	chaufför
caboose	kabyss
cabotage	kustfart
cabriolet	cabriolet
cabs	cabs
cacao	kakao
cacciatore	cacciatore
cachalot	kaskelot
cache	gömställe
cachepot	cachepot
caches	caches
cackle	kackel/kackla/prat/fnitter
cackled	cackled
cackles	cackles
cackling	cackling
cacophony	missljud
cacti	cacti
cactus	kaktus
cad	lymmel
cadavre	cadaver
cadaverous	cadaverous
caddies	caddies
caddy	teburk
cadence	cadence
cadet	yngre son/kadett
cadetship	cadetship
cadge	cadge
cadger	cadger
cafe	cafe
cafes	cafes
cafeteria	cafeteria
cafeterias	cafeterias
caffeine	caffeine
caftan	caftan
cage	bur
cages	burar
cahier	cahier
cairn	röse
cairns	cairns
caitiff	caitiff
cajole	smickra
cajoler	cajoler
cajolery	mild övertalning
gâteau	tårta/bakelse/kaka
gâteau	tårta/bakelse/kaka
calcium	kalcium
calculer	beräkna
calculated	beräknad
calibrate	kalibrera
calibrated	calibrated
calibration	calibration
auto	bil
carbonization	carbonization
carbonize	carbonize
carbonized	carbonized
carbonless	carbonless
carburetor	carburetor
carburetors	carburetors
carburization	carburization
carburize	carburize
carte	kort
cardamom	cardamom
cordial	cardiac
cardigan	kofta/stickad ylleväst
cardioid	cardioid
cardioids	cardioids
avoir soin de	varsamhet
avoir soin de	varsamhet
cared	cared
career	karriär
prudent	försiktig
carefully	noggrannt
mégère	katt
cachot	cell
cellular	cellular
hasard	chans
cherries	cherries
église	kyrkan
churches	kyrkorna
manteau	kappa
cloaks	cloaks
horloge	klocka
clockmaker	clockmaker
clockwise	medsols
cloister	pelargång/kloster
clone	klon
nuage	moln
clouds	clouds
charbon	kol
ordinateur	dator
computers	datorer
comrades	kamrater
concealed	hemliga
conjuring	conjuring
contempler	begrunda/ha för avsikt
contempler	begrunda/ha för avsikt
contempler	begrunda/ha för avsikt
contemplates	contemplates
contemplation	contemplation
contemplation	contemplation
contemplation	contemplation
contemplations	contemplations
contemplations	contemplations
contemplative	contemplative
contemporaneous	contemporaneous
contemporaneously	contemporaneously
contemporaries	contemporaries
contemporaries	contemporaries
contemporary	samtidig/samtida/jämnårig
contemporary	samtidig/samtida/jämnårig
contempt	förakt
contempt	förakt
contemptible	contemptible
contemptibly	contemptibly
contemptuous	föraktfull/hånfull
contemptuous	föraktfull/hånfull
contemptuously	contemptuously
contemptuously	contemptuously
contend	strida/tävla/påstå
contend	strida/tävla/påstå
contend	strida/tävla/påstå
contender	contender
contender	contender
contender	contender
contenders	contenders
contenders	contenders
contenders	contenders
contending	contending
contending	contending
contends	contends
contends	contends
content	innehåll
content	innehåll
content	innehåll
content	tillfredsställd
content	tillfredsställd
contentedly	contentedly
contentedness	contentedness
contention	contention
contention	contention
contention	contention
contentions	contentions
contentions	contentions
contentions	contentions
contentious	contentious
contentious	contentious
contentment	belåtenhet
contenu	innehåll
contenu	innehåll
concours	strid/bestrida/tävlan
concours	strid/bestrida/tävlan
concours	strid/bestrida/tävlan
contestant	contestant
contestant	contestant
cot	babysång/vagga/barnsäng
coterie	coterie
cotillion	cotillion
cotillon	cotillon
cottage	villa/stuga
cottager	cottager
canapé	soffa
tousser	hosta
coughs	coughs
comte	räkna
countenance	ansikte
counteract	motverka
counterbalance	counterbalance
countermand	countermand
countermarch	countermarch
counterplot	counterplot
counterpoint	kontrapunkt
counterpoise	counterpoise
counterweight	counterweight
countess	grevinna
countless	oräkneliga
campagne	land
paysan	landsman/lantman
countrywide	countrywide
county	grevskap/län
couple	par
couplet	verspar
coupon	kupong
courage	mod
courageux	modig
courageously	courageously
courier	kurir/löpare
piste	kurs/bana
courser	springare/harjägare
cour	domstol
courtois	hövlig
courteously	courteously
courteousness	courteousness
courtesy	artighet
courthouse	courthouse
courtier	hovman
courtliness	courtliness
courtly	elegant/artig
courtmartial	courtmartial
courtroom	courtroom
courtship	courtship
cousine	kusin
cove	bukt
covenant	avtal/förbund
couvrir	täcka
covert	hemlig/gömställe
covet	eftertrakta
covetous	covetous
covetously	covetously
vache	ko
vache	ko
peureux	feg/stackare
faiblesse	feghet
cowardly	cowardly
être accroupi	krypa ihop
cowherd	cowherd
cowl	huva/rökhuv
coxcomb	sprätt
coy	blyg/pryd
coyly	coyly
coyness	coyness
coyote	prärievarg
cozily	cozily
cozy	cozy
crabapple	crabapple
crabbed	crabbed
craquer	spricka upp
cracker	smällkaramell/knäckare
crackle	spraka
cradle	vagga
craft	hantverk/fartyg/flygplan
craftily	craftily
crag	brant klippa/klippspets
cram	stoppa/packa
cramp	kramp/hindra
cranberry	tranbär
grue	trana/lyftkran
cranium	cranium
crankiness	crankiness
cranky	cranky
crape	crape
crash	krascha
crate	packkorg/spjällåda
crater	crater
crave	be om/längta efter
craven	feg
ramper	kravla
écrevisse	kräfta
crayon	färgkrita
craze	mani
crazily	crazily
fou	tokiga
grincer	knarra
crème	grädde
creamy	creamy
froisser	veck/rynka
créer	skapa
creation	skapelse
creator	skapare
créature	varelse
credence	tilltro
lettre de créance	credential
credit	kredit
creditable	creditable
creditably	creditably
creditor	borgenär/fordringsägare
credo	credo
credulity	credulity
credulous	godtrogen
credulously	credulously
creed	trosbekännelse
creek	liten vik/bukt
ramper	krypa/smyga
creeps	kryper
cremate	bränna
faucher	klipp
cute	söt
cute	söt
cuteness	cuteness
cutoffs	cutoffs
cutout	cutout
cuts	klipper
cutter	kniv/tillskärare
cutting	sågning
cyanate	cyanate
cyanide	cyanid
cybernetic	cybernetic
cybernetician	cybernetician
cybernetics	cybernetics
bécane	cykel
cyclic	cyclic
cyclical	konjunkturbetingad
cyclist	cyclist
cyclists	cyklister
cycloid	cycloid
cycloidal	cycloidal
cyclone	cyclone
cyclonic	cyclonic
cyclopean	cyclopean
cyclotron	cyclotron
cylindre	cylinder
papa	pappa
daddies	daddies
papa	pappa
dads	dads
daffy	tokig
daft	tokig
dagger	dolk
dahlia	dahlia
dahlias	dahlias
journalier	daglig
daintier	daintier
aimable	utsökt/fin
dairy	mejeri/mjölkbutik
dalmate	dalmatisk
dalmatians	dalmatians
dam	damm/dämma upp/djurmoder
endommager	skada
endommager	skada
endommager	skada
endommager	skada
damaged	skadade
damaged	skadade
damager	damager
damagers	damagers
damages	skador
damaging	damaging
dame	dame
dammit	dammit
damnation	fördömelse
damned	förbaskade
damp	fuktig
dampen	bli fuktig
dampened	dampened
dampness	dampness
dams	dams
bal	dansa
dancer	dansör/dansös
dancers	dansare
dancing	dansande
pissenlit	maskros
dandelions	dandelions
dandies	dandies
dandruff	mjäll
danger	fara
dangereux	farliga
dart	pil/rusa
jour	dag
point du jour	gryning
daylight	dagsljus
days	dagar
deactivate	avaktivera
deactivation	deactivation
dead	död
sourd	döv
deaths	dödens
profond	djup
density	densitet
mériter	förtjäna
detat	detat
detre	detre
appareil	tillbehör
appareil	tillbehör
dictated	dictated
dictates	dikterar
dictation	diktamen/diktat/maktbud
dictations	dictations
dictionaries	ordböcker
dictionnaire	lexikon
did	gjorde
décéder	dö
died	dött
diesel	disel
diète	kost
dietetically	dietetically
diets	diets
différent	annorlunda/olika
difficulties	svårigheter
difficulty	svårighet
creuser	gräva/grävde/grävt
digested	digested
dignitaries	dignitaries
dignities	dignities
dignité	värdighet
dilate	utvidga
dilated	dilated
docteur	doktor
doeuvre	doeuvre
chien	hund
doggie	doggie
dogs	hundar
s'enivrer	dricka
drinks	drinkar
amener à	köra/enhet
drizzle	duggregn
sec	torr
canard	anka/and/ducka
chaque	varje
aigle	örn
eagles	örnar
eaglet	eaglet
oreille	öra
earache	earache
eardrum	eardrum
eardrums	eardrums
earlobe	earlobe
hâtif	tidig
gagner	förtjäna
earning	earning
earphones	earphones
earring	earring
earrings	earrings
ears	öron
butter	jorden
earthquake	jordbävning
earthquakes	jordbävningar
earths	earths
earthworm	daggmask
earthworms	earthworms
earwax	earwax
ease	lätthet
établi	staffli
easier	lättare
easiest	lättaste
facilement	med lätthet
easiness	easiness
est	östra
pâques	påsk
facile	lätt
déjeuner	äta
eatable	eatable
eats	äter
ebony	ebenholts
eccentric	original/originell
eccentricity	eccentricity
ecclesiastic	ecclesiastic
écho	eko
eclipse	månförmörkelse/förmörka
ecologic	ecologic
ecologist	miljöforskare
ecology	miljöforskning
economics	nationalekonomi
ecru	ecru
huit	åtta
dix-huit	arton
eighteenth	eighteenth
eightfold	eightfold
eighth	åttonde
eighties	åttitalet
eightieth	eightieth
eighty	åttio
eightyfold	eightyfold
einsteinium	einsteinium
either	varje
ejaculate	utropa
ejaculated	ejaculated
ejaculates	ejaculates
ejaculating	ejaculating
ejaculation	utrop
ejaculations	ejaculations
ejaculatory	ejaculatory
eject	tar ut
ejectable	ejectable
ejecting	ejecting
ejection	ejection
ejector	ejector
ejectors	ejectors
elaborate	genomarbeta/utveckla
elaborated	elaborated
elaborates	genomarbetar/utvecklar
elaborating	elaborating
elaboration	elaboration
elaborations	elaborations
ascenseur	hiss
onze	elva
eleventh	eleventh
eliminate	avlägsna
cesser	slut/avsluta
milieu	miljö
envoy	sändebud
envier	avund/avundas
envier	avund/avundas
escalator	rulltrappa
fonder	etablera
événement	händelse
éventuel	eventual
eventually	eventuellt
jadis	någonsin
evergreen	evergreen
infini	ständig/evig
every	varje
partout	överallt
eviction	vräkning
evidence	bevis
exclaim	utropa
fable	fable
fables	fables
fabric	tyg
fabricant	fabricant
fabriquer	uppfinna/förfalska
fabricated	fabricated
fabricates	fabricates
fabricating	fabricating
fabrication	påhitt/lögn
fabrications	fabrications
fabricator	fabricator
fabricators	fabricators
fabrics	tyger
fabulist	fabulist
fabulous	fabulous
façade	facade
facades	facades
faceless	faceless
faceplate	faceplate
facet	facet
facetious	skämtsam
facetious	skämtsam
facetiously	facetiously
facial	ansikts-
facies	facies
facile	facile
faciliter	underlätta
facilitated	främjandet
facilitates	facilitates
facilitating	facilitating
facilities	möjligheter
facility	hjälpmedel
facing	vara vänd mot
facsimile	faksimil
fact	faktum
parti	parti/partigrupp/split
factor	faktor
factorial	factorial
factorials	factorials
factories	fabriker
factorization	factorization
factorizations	factorizations
factorize	factorize
factorized	factorized
factors	faktorer
usine	fabrik
facts	fakta
factual	factual
facultative	facultative
facultatively	facultatively
faculties	faculties
faculté	förmåga/fakultet
fad	vurm/mani
pâlir	tyna
faded	tynade
fader	fader
faders	faders
fading	fading
faery	faery
faience	faience
fail	fela
faible	svimma/svag
faintly	faintly
foire	skaplig/ärlig
relativement	tämligen/ärligt
fée	fe
fidèle	trogen
faithfully	troget
actuel	modern/elegant
jeûner	snabbt
fastener	fäste
fastidious	kräsen
épais	fet
fatal	ödesdigert/dödlig
fatalism	fatalism
fatality	svår olycka
fatally	fatally
destination	ödet
pêcher	fisk
fishable	fishable
fishbowl	fishbowl
fished	fished
fisher	fisher
fisheries	fisheries
pêcheur	fiskare
fishermen	fishermen
fishers	fishers
fishery	fishery
fishes	fishes
fishing	fisket
fishtail	fishtail
fission	klyvning
fissionable	fissionable
fissure	klyfta/klyvning
poing	knytnäve
fisted	fisted
fistful	fistful
cinq	fem
fivefold	fivefold
déterminer	laga
fixation	fixation
fixations	fixations
fixity	fixity
fixture	fast tillbehör
fixtures	fixtures
fiord	fjord
fjords	fjords
fuite	flygtur
floppy	diskett
fluently	fluently
patte	fot
foot	fotboll
oublier	glömma
forgetful	glömskt
forgetfulness	glömska
forgivable	forgivable
forgivably	forgivably
excuser	förlåt
forgiveness	förlåtelse
forgives	forgives
forgiving	forgiving
forgo	avstå från/uppge
forgoes	forgoes
forgotten	glömd
forlorn	övergiven/hopplös
formaldehyde	formaldehyde
quatre	fyra
renard	räv
fractal	fraktal
fractals	fraktaler
fraction	fraktion
fractionate	fractionate
fraternal	broderlig
fraternize	fraternize
amie	vän
amitié	vänskap
fringe	frans/kanta
grenouille	groda
frogs	frogs
de	från
front	fram
fucked	knullad/knullade
fudge	fudge
fugue	fugue
fulgurant	fulgurant
peureux	rädsla
funniest	roligaste
amusant	kul
gab	prat
gabardine	gabardine
gabber	gabber
gabbing	gabbing
gaberdine	gaberdine
gadget	hjälpmedel
gaiety	glädje
gaily	glatt
acquisition	vinna
gained	vunnit
gaining	gaining
gala	gala
galactic	galactic
galaxy	lysande samling
brave	tapper/artig
gallantly	gallantly
gallantry	gallantry
galleries	galleries
galerie	galleri/läktare
gallon	gallon
gallop	galopp/galoppera
galloped	galloped
galloping	galloping
galvanic	galvanic
galvanism	galvanism
galvanize	uppliva/galvanisera
galvanized	galvanized
jeu	spel
games	spel
ail	vitlök
gaz	gas/gasa/prat/bensin
essence	bensin
ghostwriter	ghostwriter
don	present
gifts	gåvor
aller	gå/starta
but	mål
goals	mål
chèvre	get
dieu	gud
goddess	gudinna
goddesses	gudinnor
parrain	godfather
golfe	golf
golfer	golfer
golfers	golfers
golfs	golfs
bon	bra
bon	bra
adieu	adjö
goodnight	godnatt
gopher	gopher
robe	klänning/dräkt
saisir	gripa tag i
gradient	stigning
de proche en proche	gradvis
grammaire	språklära
raisin	druva
pamplemousse	grapefruit
habilitated	habilitated
habilitation	habilitation
coutume	vana
habitant	habitant
habitants	habitants
habitat	naturlig hemvist
habitation	boning/boningsplats
habitual	sed/sedvanlig
had	hade
ouvrier	hand
guider	huvud
heats	heats
ciel	himmelskt
lourd	tung
hectare	hectare
hectares	hectares
hectoliter	hectoliter
hedgehog	igelkott
heed	bekymra sig om
talon	häl/klack/klacka
heeler	heeler
heels	heels
altitude	höjd
held	höll
helices	helices
hell	helvete
hello	hallå/hej
gouvernail	roder/styre
helmet	hjälm
aider	hjälp
hemp	hampa
poulet	höna
troupeau	hjord/skock
ici	här
héron	häger
hips	höfter
battre	träff
hockey	hockey
hogwash	hogwash
holidayer	holidayer
holidays	ledigheter
domicile	hem
homeless	hemlösa
homes	hem
maison	hus
crème glacée	is
instancing	instancing
internship	internship
jab	stöt/stöta/sticka
jabber	rotvälska/pladder/pladdra
jabberwocky	jabberwocky
jabberwocky	jabberwocky
bambin	domkraft
jackal	schakal
jackals	jackals
jackass	åsnehingst
jackdaw	kaja
veste	jacka/rock
veste	jacka/rock
jackknife	jackknife
jackpot	pott
jade	hästkrake/jade
jaded	utsliten/blaserad
jag	jag
jagged	ojämn
prison	fängelse
prison	fängelse
jailbreak	jailbreak
jailed	jailed
jailer	fångvaktare
jailing	jailing
jailor	jailor
jails	fängelser
jalopy	rishög
confiture	klämma/blockera/sylt
confiture	klämma/blockera/sylt
jamb	karm
jammed	packad
jammed	packad
jangle	gnissla/oljud
janitor	portvakt
janitor	portvakt
jar	burk/gräla/gnissla
jar	burk/gräla/gnissla
jar	burk/gräla/gnissla
jargon	rotvälska/jargong
jasmine	jasmin
jaundice	gulsot
jaunt	utfärd
jaunty	ogenerad/nonchalant
javelin	spjut
mâchoire	käke
gouffre	käkar
jay	nötskrika
jazz	jazz/snack/pigga upp
jazzy	jazzig/gräll
jaloux	svartsjuk
envie	avundsjuka
jeer	hån/håna
jeer	hån/håna
jelly	gelé
jellyfish	jellyfish
jeopardize	äventyra
jeopardize	äventyra
jerk	ryck/rycka/stöt
jerk	ryck/rycka/stöt
jerry	tysk
jersey	tröja/ylletröja
jersey	tröja/ylletröja
plaisanter	skämt/skämta
jester	skämtare
jester	skämtare
jet	stråle/låga/jet
jet	stråle/låga/jet
jettison	kasta överbord
jetty	pir/kaj/brygga
bijou	juvel
jeweler	jeweler
jewelery	jewelery
jewelry	jewelry
jewels	juveler
jib	klyvare/streta emot
jib	klyvare/streta emot
jiffy	ögonblick
jig	jigg
jigsaw	lövsåg
jihad	heligt krig
jilt	trolös/kvinna/svika
tinter	klirra/klirrande
tinter	klirra/klirrande
tinter	klirra/klirrande
jinx	dra olycka
jitters	nervositet/panik
ouvrage	arbete
ouvrage	arbete
ouvrage	arbete
jobless	arbetslös
jockey	jockej
jocular	skämtsam
jocund	glad/glättig/munter
jodhpur	jodhpur
jog	knuffa/lunka
jogging	jogging
adhérer	gå med
adhérer	gå med
joinable	joinable
joined	gått med
joiner	möbelsnickare
joinery	snickeri
articulation	skarv
articulation	skarv
articulation	skarv
jointly	gemensamt
plaisanter	skämta
plaisanter	skämta
joked	skojade
joker	skämtare
jokingly	på skämt
jokingly	på skämt
jolly	glad/väldigt
jolt	skaka/skakning
jolt	skaka/skakning
jonquils	jonquils
jostle	knuffa/knuffas
jot	jota/annotera
jot	jota/annotera
journal	dagbok/tidning
journal	dagbok/tidning
journalism	journalistik
journaliste	journalist
journalists	journalister
voyage	resa
voyage	resa
jovial	gemytlig
jovially	jovially
joie	glädje
joyful	glad/glädjande
joyless	glädjelös
joyously	joyously
jubilee	jubileum
juger	domare
juger	domare
judged	dömts
arrêt	omdöme
judicial	rättslig
judiciary	domarna
judo	judo
cruche	krus/tillbringare
cruche	krus/tillbringare
cruche	krus/tillbringare
juggernaut	gudabild
jongler	jonglera
juggler	jonglör
jugular	halsblodåder
jus	saft
juiceless	saftlös
juicier	juicier
juiciest	juiciest
juicy	saftig
jukebox	jukebox
jumble	röra
jumbo	klumpeduns
sauter	hoppa
jumped	hoppade
jumpy	nervös
junction	knutpunkt
junction	knutpunkt
jungle	jungel
junior	yngre/lägre
juniper	enbuske
junk	lump/skräp/djonk
junk	lump/skräp/djonk
junk	lump/skräp/djonk
junk	lump/skräp/djonk
junkers	junkers
junkers	junkers
junkie	knarkare
junkie	knarkare
junkyard	junkyard
juridic	juridic
jurisdiction	rättskipning
jurist	rättslärd
juror	jurymedlem
jurors	jurors
jury	jury/nämnd
juste	bara
justice	rättvisa/rätt
justified	rättfärdigat
justify	rättfärdiga
justly	rättvist
jut	sticka fram
juvenile	ungdomlig
juxtapose	placera vid sidan
kale	kål
kaleidescope	kaleidescope
kaleidoscope	kaleidoscope
kangaroo	känguru
karat	karat
karate	karate
kayak	kayak
kebab	kebab
keel	köl
continuer	fortsätta/behålla
keeps	behåller
souvenir	suvenir
keg	kagge/kutting
keg	kagge/kutting
kennel	hundkoja/hundgård
kennel	hundkoja/hundgård
kerchief	huvudduk
centre	kärna/korn
centre	kärna/korn
centre	kärna/korn
kerosene	fotogen
ketchup	ketchup
chaudron	kittel
touche	tangent
touche	tangent
touche	tangent
keyboard	tangentbord
keyhole	keyhole
keying	keying
keynote	grundton/klav
keypad	keypad
khaki	khaki
kick	spark/sparka/kick
kick	spark/sparka/kick
kickback	motreaktion
kicked	kicked
kicker	kicker
kickoff	kickoff
kicks	kicks
kid	unge
kid	unge
kid	unge
kiddies	kiddies
kiddies	kiddies
kiddies	kiddies
kidnap	röva bort
kidnaped	kidnaped
kidnaper	kidnaper
kidnaper	kidnaper
kidnapers	kidnapers
kidnaping	kidnaping
kidnapped	kidnapped
kidnapper	kidnapper
kidnappers	kidnappers
kidnapping	kidnapping
kidnappings	kidnappings
rein	njure
kidneys	kidneys
kidneys	kidneys
kids	ungar
kids	ungar
rectifier	ta bort
rectifier	ta bort
killer	mördare
killer	mördare
killers	killers
killing	dödande
killing	dödande
killings	killings
killjoy	killjoy
cuisinière	brännugn
kilogramme	kilo
kilogram	kilogram
kilohertz	kilohertz
kiloliter	kiloliter
kilomètre	kilometer
kilowatt	kilowatt
kilt	kilt
kin	släkt
affable	vänlig/sort
affable	vänlig/sort
affable	vänlig/sort
kindergarten	lekskola
kindergarten	lekskola
kindergarten	lekskola
kindergarten	lekskola
kindhearted	kindhearted
kindhearted	kindhearted
kindheartedness	kindheartedness
allumer	tända
allumer	tända
kindlessly	kindlessly
kindlessly	kindlessly
kindliness	kindliness
kindliness	kindliness
kindly	välvilligt
kindly	välvilligt
kindly	välvilligt
kindly	välvilligt
amabilité	vänlighet
amabilité	vänlighet
kindred	släktskap
kindred	släktskap
kinds	vänliga
kinds	vänliga
roi	kung
royaume	kungarike
royaume	kungarike
kingdoms	kungariken
martin-pêcheur	kingfisher
kingly	konungslig
kings	kungar
kinky	krullig/excentrisk
kiosk	kiosk
kipper	rökt fisk/rökt sill
embrasser	kysser/kyss
embrasser	kysser/kyss
embrasser	kysser/kyss
embrasser	kysser/kyss
kisses	kyssar
kisses	kyssar
kit	utrustning/packning
kit	utrustning/packning
cuisine	kök
kitchenette	kokvrå
kitchens	kitchens
kitchenware	kitchenware
kitchenware	kitchenware
kite	glada/drake
kith	släktingar
kiting	kiting
kitten	kattunge
kittens	kattungar
kitty	kitty
kiwi	kiwi
kiwi	kiwi
kleenex	kleenex
kleenex	kleenex
kleptomania	kleptomania
kleptomaniac	kleptomaniac
knack	knep/vana
knack	knep/vana
sac tyrolien	ryggsäck
pétrir	knåda
kneadable	kneadable
kneader	kneader
genou	knä
kneecap	knäskål
s'agenouiller	knäböjer
s'agenouiller	knäböjer
kneeling	knäande
kneeling	knäande
kneepad	kneepad
knelt	knäböjde
knelt	knäböjde
knickers	dambyxor
knickknack	knickknack
knickknack	knickknack
couteau	kniv
couteau	kniv
knifes	knifes
knifing	knifing
chevalier	riddare/adelsman/adla
chevalier	riddare/adelsman/adla
knighted	knighted
knighthood	knighthood
knightly	knightly
knights	knights
tricoter	sticka/rynka
tricoter	sticka/rynka
tricoter	sticka/rynka
knitted	knitted
knitting	stickning
knitwear	trikåvaror
knives	knivar
knob	vred
knob	vred
knobby	knölig
knobs	knobs
frapper	slå
knockdown	knockdown
knockout	knockout
nouer	knut/knop
knots	knots
knotted	knölig
knotty	knölig/kvistig
connaître	veta
knower	knower
knowhow	knowhow
knowhow	knowhow
knowing	veta
knowingly	medvetet
knowingly	medvetet
connaissance	kunskap
connaissance	kunskap
knowledgeable	kunnig
known	kända
knows	vet
knuckle	knoge
knuckle	knoge
knucklebone	knucklebone
knuckles	knogar
koala	koala
koala	koala
kosher	kosher
kraut	kraut
kraut	kraut
krauts	krauts
kudzu	kudzu
lab	labb
labor	arbeta
ouvrier	laborer
ouvrier	laborer
laborers	laborers
dentelle	snöre/snöra/spets/spetsar
laceration	laceration
lacerations	lacerations
défaut	avsaknad
lackadaisical	lackadaisical
lackey	lakej
lacking	bristen
lackluster	lackluster
laconic	laconic
laconically	laconically
lacquer	fernissa
lacquer	fernissa
lad	pojke
ladies	damer
dame	dam/kvinna
ladybird	ladybird
ladybug	ladybug
lac	sjö
lakes	sjöar
agneau	lamm
lambs	lambs
laminated	laminated
laminates	laminates
lampe	lampa/lykta
langue	språk
rire	skratta
cuir	läder
partir	lämna
pupitre	läspulpet
conférence	föreläsning/föreläsa
lecturer	föreläsare
ledge	hylla
ledger	huvudbok/liggare
lee	lä/läsida
jambe	ben
légitime	giltiga
legality	laglighet
legalize	legalisera
legally	lagligt
legate	påvlig legat
legation	legation
legend	legend/sägen
legendary	legendariska
legion	legion
lettre	brev
lettre	brev
lettre	brev
comme	gilla/som
demeurer	leva
aimer	älska/kärlek
aimer	älska/kärlek
amante	älskare
destinée	tur
lunch	lunch/luncha
ma	mamma
ma	mamma
maam	maam
maam	maam
maam	maam
macabre	makaber
macabre	makaber
macabrely	macabrely
macadam	makadam
macadam	makadam
macadamize	macadamize
macadamize	macadamize
macadamized	macadamized
macadamized	macadamized
macadamizes	macadamizes
macadamizes	macadamizes
macadamizing	macadamizing
macaque	macaque
macaque	macaque
macaroni	macaroni
macaronies	macaronies
macaroon	macaroon
macaw	macaw
mace	spikklubba/spira
macerate	macerate
macerated	macerated
maceration	maceration
macerations	macerations
maces	maces
machete	machete
machination	intrig
machined	machined
machineries	machineries
machinery	maskiner
machines	maskiner
machinist	machinist
machinists	machinists
machismo	machismo
macho	macho
macrocephalic	macrocephalic
macrocosm	macrocosm
macroeconomics	macroeconomics
macroevolution	macroevolution
macroevolutionary	macroevolutionary
macroinstruction	macroinstruction
macromolecular	macromolecular
macromolecule	macromolecule
macromolecules	macromolecules
macropathological	macropathological
macropathology	macropathology
macrophage	macrophage
macrophages	macrophages
macrophagic	macrophagic
macroprocessor	macroprocessor
macroscopic	macroscopic
macrosimulation	macrosimulation
macrostructure	macrostructure
maculate	maculate
maculated	maculated
maculates	maculates
maculation	maculation
maculations	maculations
fou	vansinnig
fou	vansinnig
madame	min fru/fröken
madams	madams
maddened	maddened
made	gjorda/gjort
made	gjorda/gjort
mademoiselle	mademoiselle
mademoiselles	mademoiselles
maestro	maestro
mafioso	mafioso
gazette	tidning
magie	magiskt
magician	trollkarl
magicians	magicians
magistral	magistral
magistrally	magistrally
magistrature	magistrature
magma	magma
me	jag/mig
mead	mjöd/äng
prairie	äng
prairie	äng
meadowland	meadowland
meadows	ängen
maigre	meager
meagerly	meagerly
meagre	mager/torftig
farine	mål
meals	meals
moyenne	mena/betyda/tarvlig
meander	slingra sig
meaningless	meaningless
meanings	betydelse
instrument	menas
viande	kött
meats	meats
meatball	meatball
meatballs	meatballs
mechanical	mekaniker
mechanician	mechanician
mechanism	mekanism
mechanisms	mekanismer
médaille	medalj
medallion	medaljong
medallions	medallions
mediatrice	mediatrice
mediatrix	mediatrix
medic	medic
medical	medicinsk/läkar-
medically	medically
medicament	medicament
medicaments	medicaments
medicinal	medicinal
remède	medicin
medicines	medicines
medico	medico
medicolegal	medicolegal
medics	medics
medieval	medeltida
medievalist	medievalist
medievalists	medievalists
mediocre	medelmåttig
mediocrity	mediocrity
méditer	planera/meditera
meditates	meditates
meditation	meditation
meditations	meditations
meditative	meditative
medium	mellan
medlar	medlar
medley	blandning/brokig
medleys	medleys
medulla	medulla
medusae	medusae
meek	ödmjuk
meekly	meekly
meekness	meekness
meerschaum	meerschaum
megabyte	megabyte
megabytes	megabytes
megacycle	megacycle
megahertz	megahertz
megalith	megalith
megalithic	megalithic
megalomania	megalomania
megalomaniac	megalomaniac
megalomaniacal	megalomaniacal
megaphone	megaphone
melancholia	melancholia
melancholic	melancholic
melange	melange
melodic	melodic
melodies	melodies
melodious	melodious
melodrama	melodrama
melodramas	melodramas
melodramatic	melodramatic
mélodie	melodi
melon	melon
melons	meloner
melted	melted
adhérent	medlem
members	medlemmars
membrane	membran
membranes	membranes
membranous	membranous
memoir	memoir
memoirs	memoarer
memorable	minnesvärd
memories	minnen
apprendre par cur	memorera
memorized	memorerat
men	karlar
gronder	hot
menagerie	menagerie
menageries	menageries
menhir	menhir
meningitis	meningitis
meniscus	meniscus
menopause	menopause
menstrual	menstrual
menstruation	menstruation
menstruations	menstruations
intellectuel	sjäslig/sinnes-
mentality	mentality
menthol	menthol
mentionner	nämna
carte	meny
meow	meow
meowing	meowing
meows	meows
mephitic	mephitic
mercantile	handels-/affärs-
mercantilism	mercantilism
mercenaries	mercenaries
mercenary	legosoldat
commerçant	köpman
merchants	köpmän
mercure	kvicksilver
compassion	barmhärtighet
meridian	meridian
meridional	meridional
mériter	förtjänst/förtjäna
meritocracy	meritocracy
merits	meriter
mermaid	sjöjungfru
mermaids	mermaids
gai	god
message	meddelande
messages	meddelanden
messiahs	messiahs
messianic	messianska
gémir	stöna
moaned	stönade
moaning	stönande
moans	stönar
moat	vallgrav
moats	moats
mob	mob
se moquer	mock
mocked	mocked
simulacre	hån
modal	modal
moonlight	månljus/månsken
élan	älg
naïf	naiv
naively	naively
nu	naken
nom	namn/döpa
named	namngiven
nameless	anonym
namely	nämligen
namely	nämligen
names	namn/döper
national	nationell/riks-
nationalism	nationalism
nationalist	nationalist
inné	infödd
naturel	naturlig
naturalize	naturalisera
bien sûr	naturligtvis
neap	neap
près	i närheten
nearer	närmare
dédaigner	försumma
voisin	neighbor
neighbors	neighbors
filet	nätverk
networked	för nätverk
networks	nätverk
neuf	nio
dix-neuf	nitton
nineteenth	nittonde
nineties	nineties
ninetieth	ninetieth
ninety	nittio
ninetyfold	ninetyfold
ninth	ninth
niobium	niobium
nip	nypa/frostskada
mamelon	smörjkopp
nipples	nipplar
nips	nips
nirvana	nirvana
nitrate	nitrat
nitrated	nitrated
nitrates	nitrates
nitrating	nitrating
nitration	nitration
nitrations	nitrations
nitric	salpeter
nitride	nitrera
azote	kväve
nitroglycerin	nitroglycerin
nitroglycerine	nitroglycerine
élevé	adlig/ädel
noble	adelsman
noblemen	noblemen
grandeur	nobleness
nul	ingen
noctambulism	noctambulism
noctambulist	noctambulist
nocturn	nocturn
nocturnally	nocturnally
eh bien	nu
actuellement	nu för tiden
noway	noway
noway	noway
oaf	idiot
oafishness	oafishness
chêne	ek
rame	åra
oarsman	oarsman
oasis	oas
oat	havre
serment	ed/svordom
oatmeal	havremjöl
obdurate	förstockad
obedience	lydnad
docile	lydig
obelisk	obelisk
obese	fet
obesity	överdriven fetma/dästhet
océan	ocean
on	en
orange	apelsin
oranges	oranges
orbit	kretslopp
orbital	orbital
orbits	orbits
orchestre	orkester
orchestral	orchestral
orchestras	orchestras
orchestrated	orchestrated
commander	beställa/beställning
ordered	beställd
organism	organism
organisms	organisms
organist	organist
organists	organists
organization	organisation
organizations	organisationer
organiser	organisera
organized	organiserad
organs	organ
orgasm	orgasm
orgasms	orgasmer
orgies	orgies
orgie	orgie/utsvävning
orient	orienten
orientable	orientable
orientation	orientering
orientations	orientations
oriented	orienterad
orients	orients
orifice	öppning
orifices	orifices
orificial	orificial
origine	ursprung
inédit	original/ursprunglig
originality	äkthet
originally	ursprunligen
originals	originals
origins	origins
ornamental	ornamental
ornithology	ornithology
orthodoxe	orthodox
orthodoxes	orthodoxes
orthogonal	orthogonal
faire les cent pas	fart
faire les cent pas	fart
pachyderm	pachyderm
pacifique	stilla
pacifically	pacifically
pacification	pacification
pacifications	pacifications
pacificist	pacificist
pacifier	pacifier
pacifism	pacifism
pacifist	pacifist
pacify	lugna/stilla
pacify	lugna/stilla
package	paket
package	paket
packaged	packaged
packaged	packaged
packed	packad
paquet	litet paket
packing	frakt
pact	fördrag
pacts	pacts
bloc	kudde
padding	stoppning
barbotter	paddel/paddla
paddock	hästhage/sadelplats
padlock	hänglås
padlock	hänglås
padrone	padrone
paella	paella
pagan	hedning/hednisk
pagans	hedningar
pageant	festtåg
pageantry	pageantry
paid	betalad
seau	hink
douleur	smärta
pained	pained
pénible	smärtsam
pénible	smärtsam
painfully	smärtsamt
painstaking	noggrann
couleur	måla
couleur	måla
pinceau	paintbrush
peintre	målare
painters	painters
painting	tavla/målning
paints	målar
paire	par
pajamas	pyjamas
camarade	vän
camarade	vän
palais	palats
palatable	smaklig
palaver	palaver
pâle	blek
palette	färgkarta
pall	bårtäcke/äcklas
pallet	brits/hård bädd
pallette	pallette
pallor	pallor
paume	handflata
paume	handflata
palpable	kännbar
palpable	kännbar
paltry	usel
brochure	broschyr
pan	panna/kastrull/skål
panacea	panacea
panama	panama
pancake	pancake
panda	panda
pandemonium	pandemonium
pane	fönsterruta
lambris	ruta/fält/panel
paneling	paneling
panelling	panelling
pang	smärta/styng
panique	få panik
panique	få panik
panicky	panicky
panorama	panorama
pensée	pensé
pant	flämta/flämtning
panthère	panther
caleçon	trosor
buffet	skafferi
pantalon	byxor
papa	papa
document	papper/tidning
brochure	pocketbok
parameter	parameter
passer	passer
ardeur	lidelse/vrede
passionately	passionerat
passive	passiv
passivity	passivity
password	lösenord
passwords	passwords
passé	förbi
pasta	pasta
pectorals	pectorals
drôle	egendomlig
penitence	ånger
penitences	penitences
penitency	penitency
penitent	ångerfull
pentadactyl	pentadactyl
pentadactylism	pentadactylism
pi	pi
pianist	pianist
pianistic	pianistic
image	bild
pictures	bilder
pâté	tårt
pies	pies
cochon	gris
spécialité	pigeonhole
pigment	pigment
pigmentation	pigmentation
pigments	pigments
pigs	pigs
pilote	lots/lotsa/pilot
pilots	pilots
pilule	pilule
pin	barrträd/tall/tyna/tyna bort
ananas	ananas
pineapples	pineapples
pines	pines
pink	rosa
poche	fickan
pocketbook	plånbok
pocketbooks	pocketbooks
pockets	pockets
estrade	podium
pogrom	pogrom
pogroms	pogroms
pointer	pekare
pointillism	pointillism
pointillist	pointillist
pointilliste	pointilliste
pointillistic	pointillistic
poison	gift
poisonous	giftig
poisonousness	poisonousness
poisons	poisons
polar	polar
polarities	polarities
polarity	polarity
polarize	polarize
polarized	polarized
polemical	polemical
polemically	polemically
polemicize	polemicize
police	polisen
agent	polis
agent	polis
agent	polis
policemen	policemen
policemen	policemen
policemen	policemen
policewoman	policewoman
policewomen	policewomen
politique	politik
polonais	glans/polera/polska
polonais	glans/polera/polska
courtois	artig
politely	politely
politesse	artighet
political	politisk
politically	politiskt
politician	politiker
politicians	politicians
politique	politik
polka	polka
pollutant	förorenande ämne
pollute	orena/förorena
polluted	polluted
polluter	polluter
pollution	miljöförstöring
polonium	polonium
poltergeist	poltergeist
polyandrous	polyandrous
polyandry	polyandry
verser	hälla
pout	tjura
poverty	fattigdom
poudre	krut/pulver/puder
powdery	powdery
puissance	kraft
puissant	kraftfull
powerless	powerless
powwow	powwow
practicability	practicability
practicable	genomförbar
réel	praktisk
prier	bedja
prière	bön
prayers	böner
praying	praying
praying	praying
prêcher	predika
prêcher	predika
preacher	preacher
preacher	preacher
preachers	preachers
preachers	preachers
preaches	predikanter
preaches	predikanter
preachify	preachify
preaching	predikandet
preaching	predikandet
preaching	predikandet
preachy	preachy
preachy	preachy
preamplifiers	preamplifiers
prearrange	prearrange
prearrange	prearrange
prince	prince
princedom	princedom
princely	princely
princes	princes
princesse	princess
principal	huvudsaklig
principal	huvudsaklig
principalities	principalities
principality	furstendöme
principalement	principally
principalement	principally
principals	principals
principe	princip
principles	principles
impression	skriva ut
impression	skriva ut
impression	skriva ut
printed	utskriven
imprimeur	skrivare
imprimeur	skrivare
priorities	priorities
priorities	priorities
priority	prioritet
démontrer	bevisa
pouls	pulsera
pulverizable	pulverizable
pulverizables	pulverizables
pulverization	pulverization
moudre	pulverize
pulverized	pulverized
pulverizer	pulverizer
pulverizers	pulverizers
pulverizes	pulverizes
pulverizing	pulverizing
puma	puma
pomper	pump
pousser	trycka
pushchair	pushchair
pushing	trycker/tryckande
appliquer	placera/uttrycka
putdown	putdown
putout	putout
putrefaction	putrefaction
quail	vaktel/bäva/förlora modet
quails	quails
quake	skälva/skalv
propriété	kvalitet
qualm	oro/illamående
qualms	samvetskval
quantité	mängd
se disputer	gräl
quarry	byte/stenbrott
quartier	fjärdedel
quarterdeck	quarterdeck
quarterfinal	quarterfinal
queen	drottningen
queer	underlig
étouffer	undertrycka/kuva
quench	släcka/undertrycka
querulous	gnällig
query	förfrågan
recherche	sök/sökande
question	fråga
queue	köa
chicaner	rida på ord/slingra sig
prompt	snabb
quicklime	quicklime
rapidement	snabbt
quicksand	kvicksand
quicksilver	quicksilver
calme	tyst
quieten	quieten
paisiblement	tystlåtet
quill	gåspenna
coudre	sängtäcke
quirk	sarkasm/besynnerlighet/snirkel
démissioner	sluta
bien	ganska
quota	kvot
citation	citat
citer	ange
r	r
rabbet	rabbet
rabbin	rabbi
rabbinic	rabbinic
lapin	kanin
rabbits	kaniner
rabble	slödder
rabid	galen/arg
rage	rabies
raton laveur	raccoon
s'élancer	tävling/ras
racehorse	tävlingshäst
racemic	racemic
racer	racer
races	races
rachis	rachis
rachitic	rachitic
rachitis	rachitis
racialism	racialism
racialist	racialist
racialistic	racialistic
racing	racing
racism	racism
racist	racist
rack	ställning
racket	oväsen/bedrägeri/racket
racket	oväsen/bedrägeri/racket
radar	radar
radars	radars
radio	radio
lire	läsa
readability	läsbarhet
readable	läsbar
lecteur	läsare
readers	läsarna
readership	readership
readership	readership
readily	gärna
readily	gärna
readily	gärna
readiness	villighet
readiness	villighet
reading	läser
reading	läser
reading	läser
readings	readings
readings	readings
readjust	revidera
readjusts	readjusts
readjusts	readjusts
readout	avläsning
readout	avläsning
readouts	readouts
reads	läser
prêt	klar
prêt	klar
prêt	klar
reaffirm	på nytt bekräfta
reaffirm	på nytt bekräfta
reaffirms	reaffirms
reaffirms	reaffirms
reagent	reagent
effectif	riktig
effectif	riktig
effectif	riktig
realisable	realisable
realism	realism
realist	realist
realistic	realistiskt
realistic	realistiskt
realistically	realistically
réalité	verkligheten
comprendre	förstå
en réalité	verkligen
reporter	reporter
représenter	representerar
demander	begäran/efterfråga
demander	begäran/efterfråga
demander	begäran/efterfråga
chemin	väg
roads	vägar
roadwork	roadwork
ravisseur	rövare
rotting	rotting
sabbat	sabbat
sabbath	sabbat
sabbatic	sabbatic
sabbatical	sabbats-
saber	saber
sabin	sabin
sable	sobel
sabot	sabot
sabotage	sabotage/sabotera
sabotaged	saboterad
sabotages	sabotage
saboteur	sabotör
sabra	sabra
sabras	sabras
saccade	saccade
saccharin	sackarin
saccharine	sackarin
saccharose	saccharose
sacerdotal	sacerdotal
sacerdotally	sacerdotally
sachet	portionspåse
licencier	säck/avskeda/plundra
licencier	säck/avskeda/plundra
sackcloth	sackcloth
sacked	sacked
sackful	sackful
sacks	sacks
sacrament	sakrament
sacramental	sakramental
sacraments	sacraments
sacre	sacre
sacré	helig
consacrer	offer/uppoffring/uppoffra
sacrificed	uppoffrat
sacrifices	sacrifices
sacrilege	helgerån
affligé	ledsen
sadden	göra ledsen
sadder	sadder
saddest	saddest
selle	sadel
saddlebag	saddlebag
saddlebags	saddlebags
saddlebow	saddlebow
saddlecloth	saddlecloth
saddled	saddled
saddleless	saddleless
saddler	saddler
saddlery	saddlery
saddles	saddles
saddletree	saddletree
sadism	sadism
sadist	sadist
sadistic	sadistiska
sadistically	sadistically
sadists	sadists
sadly	ledsamt
affliction	sorg
safari	safari
à l'abri	säker
safecracker	safecracker
safecracking	safecracking
safeguard	skydd/säkra
safeguarded	safeguarded
safeguards	safeguards
safer	säkrare
safest	säkraste
sécurité	säkerhet
safflower	safflower
saffron	saffron
sag	bågna/sjunka
saga	saga
intelligent	sagacious
sagaciously	sagaciously
sagaciousness	sagaciousness
sagacity	skarpsinne/klokhet
sauge	vis/salvia
sagely	sagely
sago	sago
saguaro	saguaro
sahib	sahib
said	sa
voile	segla
voile	segla
sailable	sailable
sailboat	sailboat
sailboater	sailboater
sailcloth	sailcloth
sailors	sjömän
sails	sails
sainfoin	sainfoin
saint	helgon/sankt/sankta
sainted	sainted
sainthood	sainthood
saith	saith
sake	skull
salability	salability
salacious	salacious
salade	salad
salads	salads
salamander	salamander
salaried	salaried
salaries	salaries
sale	försäljning
saleable	säljbar
saleroom	saleroom
salesclerk	salesclerk
salesgirl	salesgirl
saleslady	saleslady
marchand	försäljare
salesmanship	salesmanship
salesmen	försäljare
salespeople	salespeople
salesperson	salesperson
salesroom	salesroom
saleswoman	saleswoman
saleswomen	saleswomen
salient	framträdande/utskjutande
saline	salthaltig/saltdamm
salinity	salinity
salinometer	salinometer
salinometers	salinometers
salive	saliva
salivary	salivary
salivate	salivate
salivated	salivated
salivates	salivates
salivating	salivating
salivation	salivation
sallies	sallies
pâle	gulblek/sälg
sallowish	sallowish
saumon	lax
salmons	salmons
salon	salon
salons	salons
saler	salt/salta
saltwater	saltwater
saltworks	saltworks
saltwort	saltwort
salty	salt
salubrious	hälsosam
salubrity	salubrity
salut	bärga/bärgning
salver	silverbricka
samba	samba
identique	samma
sampan	sampan
samphire	samphire
samurai	samurai
samurais	samurais
sable	sand
sandale	sandal
école	skola
mer	hav/sjö/sjögång
vendre	sälja
seller	säljare
sellers	sellers
serendipity	serendipity
serein	lugn/fridfull
36770	sju
sevenfold	sevenfold
dix-sept	sjutton
seventeenth	seventeenth
seventh	seventh
seventies	seventies
seventieth	seventieth
seventy	seventy
seventyfold	seventyfold
sever	hugga av/skilja
sévère	kännbara/stränga
severed	severed
severely	kännbart
severities	severities
severity	stränghet
sewage	avloppsvatten
sexe	kön
sexagenarian	sexagenarian
sexual	sexuell
sexually	sexuellt
shades	nyanser
ombre	skugga
shadows	skuggor
shagreen	shagreen
schah	shah
secouer	skaka
shakedown	shakedown
shaken	shaken
shaky	skakande/skral/svag
shaman	shaman
shamanism	shamanism
shampoo	shampoo
shampoos	shampoos
mouton	får
sheepherder	sheepherder
expédier	skepp
expédier	skepp
shit	skit
malade	sjukt
argent	silver
chanter	sjunga
chanteuse	sångare
forer	sjunka
six	sex
seize	sexton
sixteenth	sixteenth
sixties	sixties
soixante	sextio
sixtyfold	sixtyfold
ampleur	storlek
patin	skridsko/åka skridsko
skateboard	skateboard
skateboarder	skateboarder
skateboarding	skateboarding
skateboards	skateboards
skater	skater
skaters	skaters
skates	skates
skating	skating
adresse	skicklighet
skilled	skicklig/yrkesutbildad
skilless	skilless
adroit	skicklig
ciel	himmel
skylark	lärka
skyscraper	skyscraper
snout	tryne
neiger	snö
snowball	snowball
flocon de neige	snöflinga
snowman	snögubbe
snowstorm	snowstorm
software	programvara
sorrily	sorrily
sorrow	sorg
sorte	sortera
sorted	sorterad
sorter	sorter
âme	själ
spectra	spectra
spectrum	spectrum
speculate	spekulera
speculation	spekulation
parenthèse	stapelvara/krampa/märla
stapled	stapled
stapler	stapler
staplers	staplers
staples	staples
étoile	stjärna
stars	stjärnor
activer	starta
stifled	stifled
force	styrka
sot	dum
sujet	ämne
arriver	lyckas/efterträda
prospérité	framgång
soleil	sol
sunbathe	sunbathe
sunny	sunny
suppressed	undertryckt
soupçonner	misstänka
blasphémer	svär
tab	lapp/etikett
tab	lapp/etikett
tabernacle	tabernakel
liste	bord
tableau	tablå
tableaus	tableaus
tableaux	tableaux
tablecloth	bordsduk
tablecloths	tablecloths
tables	tabeller
liste	skrivblock
tablets	lertavlor
taboos	taboos
tachometer	tachometer
tachometers	tachometers
tacit	tyst/underförstådd
queue	svans
couturière	skräddare
tailored	tailored
tailors	tailors
habit	svansar
devoir	uppgift
tasks	uppgifter
goût	smaka
tasted	smakade
tasteless	smaklös
larme	riva sönder
larme	riva sönder
larme	riva sönder
larme	riva sönder
teardrop	teardrop
tearful	tearful
tearfully	tearfully
tearfully	tearfully
teargas	teargas
tearjerker	tearjerker
tearless	tearless
tearless	tearless
tearoom	tearoom
tears	tårar
tears	tårar
tearstained	tearstained
tearstained	tearstained
agacer	reta/retas
agacer	reta/retas
agacer	reta/retas
teasel	teasel
teaser	svår uppgift
teaser	svår uppgift
teases	teases
teases	teases
teases	teases
teasing	teasing
teasing	teasing
teasingly	teasingly
teasingly	teasingly
teaspoon	teaspoon
teaspoon	teaspoon
teaspoonful	teaspoonful
mamelle	spene
mamelle	spene
mamelle	spene
mamelle	spene
teatime	teatime
teats	teats
teats	teats
dix	tio
tendencies	tendencies
aptitude	benägenhet/tendens
tenderfoot	tenderfoot
tenderly	ömt
thence	thence
thence	thence
thenceforth	thenceforth
thenceforward	thenceforward
theocracy	theocracy
theocratic	theocratic
theodolite	theodolite
theologian	teolog
theologians	teologer
theological	theological
theologically	theologically
theology	teologi
theorem	theorem
theorems	theorems
theoretical	teoretisk
theoretical	teoretisk
theoretically	theoretically
theoretician	theoretician
theoretician	theoretician
theoreticians	theoreticians
theoreticians	theoreticians
theorist	theorist
theorist	theorist
theorists	theorists
theorists	theorists
theorize	theorize
thief	tjuv
quoique	fastän
quoique	fastän
pensée	tänkte
pensée	tänkte
thoughtful	tankfull
thoughtfully	thoughtfully
précaution	thoughtfulness
thoughtless	thoughtless
thoughtlessly	thoughtlessly
thoughtlessness	thoughtlessness
mille	tusental
thousandth	thousandth
thrash	klå/tröska
thrash	klå/tröska
fil	tråd
fil	tråd
fil	tråd
threadbare	trådsliten/banal
menace	hot
gronder	hota
sinistre	threatening
threateningly	threateningly
trois	tre
tigress	tigress
aujourd'hui	idag
doigt du pied	tå
tradition	tradition
traditional	traditionell
trail	spår
clique	tåg/träna
trainee	trainee
trainer	tränare
traitor	förrädare
transaction	transaktion
transalpine	transalpine
transcribe	transcribe
passer	överföring
traduire	översätta
translation	översättning
translator	översättare
adresser	sända
arbre	träd
camiono	lastbil/transportera
deux	två
ubiquitous	allestädes närvarande
ubiquity	ubiquity
pis	juver
ugh	usch
uglier	uglier
ugliest	ugliest
uglify	uglify
uglily	uglily
ugliness	fulhet
laid	otäckt
ukulele	ukulele
ulcère	varigt sår/böld
ulcerate	ulcerate
ulcerated	ulcerated
ulceration	ulceration
ulcerative	ulcerative
ulna	ulna
ultimo	ultimo
unemployment	arbetslöshet
vacant	ledigt
vacate	utrymma
vacances	semester
vacciner	vaccinera
vaccinated	vaccinated
vacuum	tomrum
vacuumed	vacuumed
vagin	slida
vagrant	luffare
vague	vag/svävande
vain	fåfäng
wacky	wacky
wag	vagga/vifta
noix	valnöt
warehouse	magasin
warehouse	magasin
warehouses	warehouses
laver	tvätta
pleurer	gråta
weeping	gråt
weeping	gråt
weeps	weeps
weepy	gråtmild
weepy	gråtmild
weevil	vivel
weft	inslag i väv
peser	väga
peser	väga
weighing	weighing
weighings	weighings
weighs	väger
poids	vikt
weighted	weighted
weighted	weighted
weightily	weightily
weighting	weighting
weighting	weighting
weightless	weightless
weightlessness	weightlessness
weights	belastningar
weights	belastningar
weighty	tung
weighty	tung
weir	fördämning/damm
bizarre	konstig
weirdie	weirdie
weirdies	weirdies
weirdly	weirdly
weirdness	weirdness
weirdness	weirdness
weirdo	weirdo
weirdos	weirdos
weirs	weirs
recevoir solennellement	välkommen
recevoir solennellement	välkommen
recevoir solennellement	välkommen
recevoir solennellement	välkommen
où	var
fenêtre	fönster
fenêtre	fönster
windowpane	windowpane
windowpanes	windowpanes
windows	windows
windstorm	windstorm
vin	vin
wineglass	vinglas
winegrower	winegrower
winemaker	winemaker
winemaking	winemaking
winepress	winepress
wines	wines
winey	winey
aile	vinge/flygel/eskader
winglet	winglet
wink	blinka
hiver	vinter
effacer	torka
fil	tråd/telegram/telegrafera
fil	tråd/telegram/telegrafera
fil	tråd/telegram/telegrafera
wired	wired
radio	trådlös/radio
wiring	kabeldragning
wiry	senig/seg
intelligence	klokhet
raisonnable	klokt
wisecrack	kvickhet/kvickhuvud
wisely	klokt
wiser	wiser
désirer	önskar
désirer	önskar
wishbone	wishbone
wishes	önskar
wishful	wishful
witch	häxa
witches	witches
à	med
décéder	dra tillbaka
décéder	dra tillbaka
sans	utan
témoin	bevittna
témoin	bevittna
witnesses	vittnen
wolverine	järv
wolverine	järv
monde	värld
worldwide	världsomspännande
xenophobe	främlingsskräck
xenophobia	främlingsskräck
xenophobic	xenophobic
xerographic	xerographic
xylem	xylem
xylene	xylene
xylophone	xylophone
xylophones	xylophones
xylophonist	xylophonist
xylose	xylose
xylotomic	xylotomic
yacht	lustjakt
yachting	segling
yachtsman	seglare
yak	jak
igname	jams
yap	gläfsa
cour	gård
yardstick	tumstock
yarn	garn/skepparhistoria
bâiller	gäspa
bâiller	gäspa
yawning	gäspande
yeah	ja
an	år
yearbook	årsbok
yearlong	yearlong
annuellement	årlig/årligen
annuellement	årlig/årligen
aspirer	längta
yearning	längtande
yearningly	yearningly
years	år
yeast	jäst
yell	vråla
yell	vråla
jaune	gul
yellowed	yellowed
yellowing	yellowing
yellowish	yellowish
bien	ja
hier	igår
encore	ännu
yew	idegran
abandonner	avkastning/vika sig
yoga	yoga
yaourt	yoghurt
yogurt	yogurt
yoke	ok
yolk	äggula
te	du/ni
te	du/ni
jeune	ung
younger	yngre
youngster	pojkspoling
youth	ungdom
youthful	ungdomlig
yuppie	yuppie
zabaglione	zabaglione
zany	dumbom
zazen	zazen
ferveur	iver/nit
fervent	ivrig/nitisk
zèbre	sebra
zenith	zenith
zero	noll
zero	noll
vigueur	krydda/aptit
zigzag	sicksack
zinc	zink
fermeture éclair	blixtlås
zodiac	zodiac
zodiac	zodiac
zone	zon/bälte
zone	zon/bälte
zoo	zoologisk trädgård
zoology	zoologi
zoom	zoom
zucchini	zucchini
