ein	ein/eit
ein	ein/eit
aardvark	aardvark
aardvark	aardvark
aardvarks	aardvarks
zurück	tilbake
zurück	tilbake
zurück	tilbake
abacterial	abacterial
abacus	abacus
abacus	abacus
abacus	abacus
abacuses	abacuses
abacuses	abacuses
abacuses	abacuses
abaft	abaft
abalone	abalone
abalones	abalones
ablassen	abandon
ablassen	abandon
impertinent	abandoned
impertinent	abandoned
impertinent	abandoned
abandonee	abandonee
abandoner	abandoner
abandoning	abandoning
zession	abandonment
zession	abandonment
abandonments	abandonments
demütigen	abase
abased	abased
abasement	abasement
abasements	abasements
abases	abases
beschämen	abash
verlegen	abashed
verlegen	abashed
abasing	abasing
erschlaffen	minske
erschlaffen	minske
abated	abated
nachlaß	abatement
nachlaß	abatement
abatements	abatements
abates	abates
abating	abating
abating	abating
abattoir	abattoir
abbe	abbe
abberations	abberations
abtei	abbedi
abtei	abbedi
abbeys	abbeys
abt	abbot
abt	abbot
abt	abbot
abt	abbot
abt	abbot
abbots	abbots
abkürzen	abbreviate
abkürzen	abbreviate
abbreviated	abbreviated
abbreviates	abbreviates
abbreviating	abbreviating
verkürzung	forkortelse
verkürzung	forkortelse
verkürzung	forkortelse
verkürzungen	abbreviations
verkürzungen	abbreviations
abbreviator	abbreviator
abdicable	abdicable
abdanken	abdicate
abdanken	abdicate
abdicated	abdicated
abdication	abdication
abdicator	abdicator
hinterleib	abdomen
hinterleib	abdomen
abdomens	abdomens
den unterbauch betreffend	abdominal
abdominally	abdominally
abduct	abduct
abducted	abducted
abducting	abducting
abduction	abduction
abductions	abductions
abductor	abductor
abductors	abductors
quer	abeam
abecedarian	abecedarian
abed	abed
abweichung	aberrance
aberrant	aberrant
aberrantly	aberrantly
aberration	feil/mistak
aberration	feil/mistak
aberrations	aberrations
agitieren	hjelpe
mithilfe	abetment
abets	abets
abetted	abetted
abetter	abetter
abetting	abetting
abettor	abettor
ruhen	abeyance
abeyant	abeyant
verabscheuen	abhor
abhorred	abhorred
abscheu	abhorrence
abhorrent	abhorrent
abhorrently	abhorrently
abhorring	abhorring
abhors	abhors
gewärtigen	vente
abided	abided
abides	abides
fest	abiding
abilities	abilities
kapazität	dyktighet
kapazität	dyktighet
abiotic	abiotic
gemein	abject
abjection	abjection
abjectly	abjectly
abjuration	abjuration
annullieren	abjure
abjurer	abjurer
ablation	ablation
ablativ	ablative
ablaze	ablaze
ablaze	ablaze
begabt	dyktig
begabt	dyktig
begabt	dyktig
begabt	dyktig
abler	abler
ablest	ablest
abloom	abloom
ablution	ablution
ablutions	ablutions
ably	ably
abnegate	abnegate
abnegates	abnegates
aufopferung	abnegation
abnormal	abnorm
abnormal	abnorm
abnormal	abnorm
abnormalities	abnormalities
abnormalität	abnormality
abnormally	unormalt
an bord	ombord
wohnort	abode
abodes	abodes
aboil	aboil
annullieren	avskaffe
annullieren	avskaffe
abolishable	abolishable
abolished	avskaffet
abolisher	abolisher
abolishes	abolishes
abolishment	abolishment
abolition	abolition
abolition	abolition
abolitionism	abolitionism
abolitionist	abolitionist
abolitionists	abolitionists
abscheulich	avskyelig
abominably	abominably
verabscheuen	abominate
abscheu	abomination
abominations	abominations
eingeboren	aboriginal
aboriginally	aboriginally
aborigine	aborigine
aborigines	aborigines
abortieren	abort
aborted	aborted
aborter	aborter
aborting	aborting
fiasko	abort
fiasko	abort
abortionist	abortionist
abortionists	abortionists
abortions	abortions
nutzlos	abortive
abortively	abortively
aborts	aborts
schwärmen	abound
betreffs	om
oberhalb	over
aboveboard	aboveboard
aboveground	aboveground
abovementioned	abovementioned
abovementioned	abovementioned
abracadabra	abracadabra
abradable	abradable
hobeln	abrade
abrasion	abrasion
abrasions	abrasions
grell	abrasive
abrasives	abrasives
abreast	abreast
begrenzen	forminske
abridged	abridged
übersicht	abridgement
abridging	abridging
äußerlich	utenlands
annullieren	abrogate
abrogated	abrogated
abrogation	abrogation
abgerissen	abrupt
abruptly	abruptly
abruptness	abruptness
abszeß	byll
abscesses	abscesses
ausreißen	abscond
absconded	absconded
abwesenheit	fravær
absences	absences
abwesend	fraværende
abwesend	absentee
absenteeism	absenteeism
absentees	absentees
abwesend	absently
absentminded	absentminded
absentmindedly	absentmindedly
absentmindedly	absentmindedly
absentmindedness	absentmindedness
beifuß	absinth
beifuß	absinthe
absolut	absolutt
freilich	absolutt
begnadigung	absolution
absolutismus	absolutism
absolvieren	absolve
absolved	absolved
absolving	absolving
absorbieren	oppta
absorbability	absorbability
absorbable	absorbable
absorbant	absorbant
absorbed	absorbed
absorbent	absorbent
absorbing	absorbing
absorption	absorption
abstain	abstain
abstained	abstained
abstinent	abstemious
abstinenz	abstention
abstentions	abstentions
abstinenz	abstinence
abstinent	abstinent
abstinently	abstinently
abstrakt	abstrakt
abstrakt	abstrakt
diebstahl	abstraction
geheimnissvoll	abstruse
abgeschmackt	absurd
absurdism	absurdism
absurdist	absurdist
absurdities	absurdities
verdrehtheit	absurdity
reichtum	overflod
reichlich	abundant
im überfluß	abundantly
beleidigen	misbruk
abused	abused
anzüglich	abusive
abusively	abusively
abut	abut
abuzz	abuzz
unerforschlich	abysmal
abysmally	abysmally
abgrund	avgrunn
abgrund	avgrunn
abysses	abysses
abysses	abysses
akazie	acacia
student	student
academical	academical
academically	academically
academician	academician
academies	academies
academism	academism
akademie	akademi
akanthus	acanthus
acanthuses	acanthuses
beipflichten	accede
beipflichten	accede
beeilen	aksellerere
accelerated	accelerated
acceleration	acceleration
accelerations	accelerations
accelerator	gasspedal
accelerators	accelerators
accelerometer	accelerometer
accelerometers	accelerometers
accent	aksent
betonte	accented
betonte	accented
accents	accents
accentual	accentual
accentually	accentually
betonen	accentuate
accentuated	accentuated
accentuation	accentuation
annehmen	akseptere
acceptability	acceptability
acceptable	acceptable
acceptably	acceptably
annahme	acceptance
accepted	accepted
accepter	accepter
acceptor	acceptor
anfall	tilgang
accessed	accessed
accessibility	accessibility
zugänglich	tilgjengelig
errungenschaft	accession
accessorial	accessorial
zubehör	tilbehør
accessorize	accessorize
accessors	accessors
accessory	accessory
unfall	ulykke
zufällig	tilfeldig
accidentalism	accidentalism
accidentalist	accidentalist
accidentally	accidentally
accidently	accidently
accidents	ulykker
akklamieren	acclaim
beifall	acclamation
acclimate	acclimate
acclimated	acclimated
akklimatisieren	tilpasse
accolade	accolade
accolades	accolades
adaptieren	accommodate
accommodated	accommodated
entgegenkommend	imøtekommende
einrichtung	husrom
accommodations	accommodations
accompanied	accompanied
accompanier	accompanier
accompanies	accompanies
geleit	accompaniment
accompaniments	accompaniments
gefährte	accompanist
accompanists	accompanists
begleiten	ledsage
accompanyist	accompanyist
accompanyists	accompanyists
accomplice	accomplice
accomplices	accomplices
erlangen	fullende
accomplished	flink
accomplishment	accomplishment
accomplishments	accomplishments
akkord	accord
accordance	accordance
accorder	accorder
accorders	accorders
ziehharmonika	trekkspill
accordionist	accordionist
accordionists	accordionists
accordions	accordions
accords	accords
ansprechen	accost
konto	konto
accountability	accountability
accountable	ansvarlig
buchrevisor	accountant
buchführung	accounting
accouterment	accouterment
accrued	accrued
accruement	accruement
accumulated	samlet
acetaminophen	acetaminophen
acetify	acetify
acetone	acetone
herb	syre
acidic	acidic
allergen	allergen
allergen	allergen
allergic	allergisk
allergies	allergier
allergies	allergier
allergie	allergi
allergie	allergi
alleviate	alleviate
alleviated	lette
gasse	alle
gasse	alle
alleys	alleys
alleys	alleys
verbindlichkeit	allianse
verbindlichkeit	allianse
alliances	alliances
alliances	alliances
allied	allied
allied	allied
alligator	alligator
alligator	alligator
alligators	alligators
alligators	alligators
alliteration	alliteration
alliteration	alliteration
alliterations	alliterations
alliterations	alliterations
allocate	allocate
allocated	allocated
allocation	allocation
allocation	allocation
allocations	allocations
allocution	allocution
allocution	allocution
allocution	allocution
verlosen	fordele
lassen	forlate
zulässig	allowable
erlaubnis	tilstand
erlaubt	allowed
legierung	alloy
alphabet	alfabet
alphabetic	alphabetic
alphabetical	alphabetical
alphabetization	alphabetization
alphabetizations	alphabetizations
alphabetize	alphabetize
alphabetized	alphabetized
alphabetizing	alphabetizing
alphabets	alphabets
alphamerical	alphamerical
alphanumerisch	alphanumeric
alphanumerical	alphanumerical
alphanumerically	alphanumerically
alphanumerics	alphanumerics
alpine	alpine
alpinism	alpinism
alpinist	alpinist
bereits	allerede
auch	også
altercation	altercation
altercations	altercations
sich ablösen	svitsje
alternated	alternated
alternately	alternately
unter	blant
amoral	amoral
amorous	amorous
amorously	amorously
amorph	amorphous
anzahl	beløp
anzahl	beløp
amp	amp
ampère	ampere
ampersand	ampersand
amphetamine	amphetamine
und	og
anyway	allikevel
irgendwo	anywhere
aorta	aorta
schnell	raskt
abgesondert	atskilt
apartheid	apartheid
appartement	leilighet
indolent	apathetic
apathie	apathy
affe	ape
affe	ape
aperitif	aperitiff
öffnung	aperture
spitze	spits
aphid	aphid
eintreffen	ankomme
espe	aspen
kontrollieren	audit
auditorium	auditorium
auditoriums	auditoriums
audits	audits
verfügbar	disponibel
quasseln	babble
babbler	babbler
babies	babies
pavian	baboon
kinder	baby
baccalaureate	baccalaureate
baccarat	baccarat
hagestolz	bachelor
bachelors	bachelors
bacilli	bacilli
bacillus	basill
rücken	tilbake
backache	backache
backbite	backbite
wirbelsäule	backbone
hintergrund	bakgrunn
backgrounds	backgrounds
after	backside
backslide	backslide
backup	backup
backward	backward
speck	flesk
bakterien	bacteria
böse	dårlig
insignien	badge
badged	badged
badgers	badgers
badinage	badinage
beutel	sekk/veske
lapalie	bagatelle
bagatelles	bagatelles
bagage	bagasje
bags	bags
baguette	baguette
bah	bah
bail	bail
köder	agn
backen	bake
bäcker	baker
bakeries	bakeries
bakers	bakers
bäckerei	bakeri
bakeshop	bakeshop
saldo	balanse
balconies	balconies
altan	altan/balkon
kahlköpfig	skallet
baldhead	baldhead
baldly	baldly
baldness	baldness
bale	bale
baleen	baleen
hindern	balk
ball	ball
ballade	ballad
ballade	ballade
ballads	ballads
ballast	ballast
ballett	ballet
balletic	balletic
ärostat	ballong
ballot	ballot
balls	balls
ballyhoo	ballyhoo
balsam	balm
bambus	bambus
betrügen	bamboozle
banane	banan
bananas	bananas
bande	band
bandage	bind
bandeau	bandeau
bandit	banditt
bandits	bandits
bandleader	bandleader
bandmaster	bandmaster
bane	bane
banished	banished
barb	barb
barbar	barbarian
barbarians	barbarians
barbarismus	barbarism
barbier	barbermester/frisør
barmaid	barmaid
barman	barman
kaserne	barracks
strand	strand
aushalten	bjørn
aushalten	bjørn
beet	seng
schlafzimmer	soverom
glauben	tror
verraten	forråde
bibliographic	bibliographic
bibliographies	bibliographies
bibliographie	bibliography
brombeere	blackberry
buch	bok
boomerang	boomerang
boxer	boxer
junge	gutt
boys	gutter
gehirn	hjerne
brood	brood
besen	kost
broth	broth
bauen	bygge
anbau	bygning
adieu	hadet
droschke	cab
cabal	cabal
cabala	cabala
cabalism	cabalism
cabalist	cabalist
cabalistic	cabalistic
caballero	caballero
cabaret	kabaret
kohl	kål
cabbages	cabbages
cabdriver	cabdriver
hütte	hytte
kabinett	cabinet
cabinetmaker	cabinetmaker
cabinetmakers	cabinetmakers
cabinets	cabinets
cabins	cabins
kabel	cable
cabled	cabled
cablegram	cablegram
cablegrams	cablegrams
cables	cables
cabling	cabling
chauffeur	cabman
caboose	caboose
cabotage	cabotage
cabriolet	cabriolet
cabs	cabs
cacao	cacao
cacciatore	cacciatore
cachalot	cachalot
cache	cache
cachepot	cachepot
caches	caches
cackle	cackle
cackled	cackled
cackles	cackles
cackling	cackling
cacophony	cacophony
cacti	cacti
kaktus	cactus
cad	cad
kadaver	cadaver
cadaverous	cadaverous
caddies	caddies
caddy	caddy
cadence	cadence
cadet	cadet
cadetship	cadetship
cadge	cadge
cadger	cadger
cafe	cafe
cafes	cafes
cafeteria	cafeteria
cafeterias	cafeterias
caffeine	caffeine
kaftan	caftan
bauer	bur
cages	cages
cahier	cahier
cairn	cairn
cairns	cairns
caitiff	caitiff
cajole	cajole
cajoler	cajoler
cajolery	cajolery
kuchen	kake
kuchen	kake
kalcium	calcium
erachten	beregne
calculated	calculated
calibrieren	calibrate
calibrated	calibrated
calibration	calibration
auto	bil
carbonization	carbonization
carbonize	carbonize
carbonized	carbonized
carbonless	carbonless
carburetor	carburetor
carburetors	carburetors
carburization	carburization
carburize	carburize
karte	kort
cardamom	cardamom
cardiac	cardiac
cardigan	cardigan
cardioid	cardioid
cardioids	cardioids
sorge tragen	care
sorge tragen	care
cared	cared
karriere	career
bedächtig	forsiktig
sorgfältig	carefully
katze	katt
karzer	cell
cellular	cellular
zufällig	anledning
die kirschen	kirsebær
kirche	kirke
churches	churches
mantel	kåpe
cloaks	cloaks
uhr	klokke
clockmaker	clockmaker
clockwise	clockwise
cloister	cloister
clone	clone
wolke	sky
clouds	clouds
kohle	kull
computer	pc
computers	computers
comrades	comrades
concealed	concealed
conjuring	conjuring
contemplate	contemplate
contemplate	contemplate
contemplate	contemplate
contemplates	contemplates
contemplation	contemplation
contemplation	contemplation
contemplation	contemplation
contemplations	contemplations
contemplations	contemplations
contemplative	contemplative
contemporaneous	contemporaneous
contemporaneously	contemporaneously
contemporaries	contemporaries
contemporaries	contemporaries
zeitgenössisch	contemporary
zeitgenössisch	contemporary
verachtung	contempt
verachtung	contempt
contemptible	avskyelig
contemptibly	contemptibly
contemptuous	contemptuous
contemptuous	contemptuous
contemptuously	contemptuously
contemptuously	contemptuously
contend	contend
contend	contend
contend	contend
contender	contender
contender	contender
contender	contender
contenders	contenders
contenders	contenders
contenders	contenders
contending	contending
contending	contending
contends	contends
contends	contends
inhalt	content
inhalt	content
inhalt	content
zufrieden	contented
zufrieden	contented
contentedly	contentedly
contentedness	contentedness
contention	contention
contention	contention
contention	contention
contentions	contentions
contentions	contentions
contentions	contentions
contentious	contentious
contentious	contentious
contentment	contentment
inhalt	contents
inhalt	contents
konkurrenz-prüfung	contest
konkurrenz-prüfung	contest
konkurrenz-prüfung	contest
contestant	contestant
contestant	contestant
kinderbett	cot
coterie	coterie
cotillion	cotillion
cotillon	cotillon
häuschen	hytte
cottager	cottager
couch	divan
husten	hoste
coughs	coughs
rechne	regne
angesicht	fjes
counteract	counteract
counterbalance	counterbalance
countermand	countermand
countermarch	countermarch
counterplot	counterplot
counterpoint	counterpoint
counterpoise	counterpoise
counterweight	counterweight
countess	countess
zahllos	countless
gefilde	land
countryman	bonde
countrywide	countrywide
county	county
ehepaar	couple
couplet	couplet
coupon	coupon
mut	mot
beherzt	courageous
courageously	courageously
courier	courier
kurs	kurs
courser	courser
den hof machen	court
artig	courteous
courteously	courteously
courteousness	courteousness
courtesy	courtesy
courthouse	courthouse
courtier	courtier
courtliness	courtliness
courtly	courtly
courtmartial	courtmartial
gericht	courtroom
courtship	courtship
base	fetter
cove	cove
vereinbarungen	covenant
einband	dekk
covert	covert
gelüsten	covet
covetous	covetous
covetously	covetously
kuh	ku
kuh	ku
coward	coward
cowardice	cowardice
cowardly	cowardly
kauern	cower
cowherd	cowherd
kappe	cowl
coxcomb	coxcomb
coy	coy
coyly	coyly
coyness	coyness
coyote	coyote
cozily	cozily
cozy	koselig
crabapple	crabapple
crabbed	crabbed
spalte	crack
cracker	cracker
knistern	crackle
wiege	vugge
craft	craft
craftily	craftily
crag	crag
cram	cram
cramp	cramp
cranberry	cranberry
kranich	crane
cranium	cranium
crankiness	crankiness
cranky	cranky
crape	crape
crash	krasje
crate	crate
crater	crater
crave	crave
feig	craven
kriechen	crawl
krebs	crayfish
buntstift	crayon
wut	craze
crazily	crazily
irre	gæren
fletschen	creak
rahm	krem
creamy	creamy
zerknittern	crease
schaffen	danne
creation	creation
creator	creator
gebilde	creature
credence	credence
credential	credential
kredit	kreditt
creditable	creditable
creditably	creditably
gläubiger	creditor
credo	credo
credulity	credulity
leichtgläubig	credulous
credulously	credulously
creed	creed
creek	bekk
kriechen	creep
creeps	creeps
brennen	svi
mähen	kutt
süss	cute
süss	cute
cuteness	cuteness
cutoffs	cutoffs
cutout	cutout
schneidet	cuts
cutter	cutter
cutting	cutting
cyanate	cyanate
cyanide	cyanide
cybernetic	cybernetic
cybernetician	cybernetician
cybernetics	cybernetics
fahrrad	syklus
cyclic	cyclic
cyclical	cyclical
cyclist	cyclist
cyclists	cyclists
cycloid	cycloid
cycloidal	cycloidal
wirbelwind	cyclone
cyclonic	cyclonic
cyclopean	cyclopean
cyclotron	cyclotron
walze	sylinder
väterchen	far
daddies	daddies
väterchen	daddy
dads	dads
verrückt	daffy
verrückt	daft
dolch	dagger
dahlia	dahlia
dahlias	dahlias
täglich	daily
daintier	daintier
delikat	dainty
milchgeschäft	meieri
dalmatian	dalmatian
dalmatians	dalmatians
gehege	dam
beschädigen	skade
beschädigen	skade
beschädigen	skade
beschädigen	skade
damaged	damaged
damaged	damaged
damager	damager
damagers	damagers
schäden	damages
damaging	damaging
dame	dame
dammit	dammit
damnation	damnation
damned	damned
feucht	damp
dampen	dampen
dampened	dampened
dampness	dampness
dams	dams
ball	dans
der tänzer	dancer
dancers	dancers
dancing	dancing
hundebluhme	dandelion
dandelions	dandelions
dandies	dandies
dandruff	dandruff
gefahr	fare
besorglich	dangerous
dart	dart
tag	dag
tagesanbruch	daybreak
daylight	daylight
tagen	dager
deactivate	deactivate
deactivation	deactivation
sterblich	død
taub	døv
deaths	deaths
tief	dyp
dichte	density
verdienen	deserve
detat	detat
detre	detre
apparat	device
apparat	device
dictated	dictated
dictates	dictates
dictation	dictation
dictations	dictations
wörterbücher	orbøker
wörterbuch	ordbok
machte	did
sterben	die
died	died
diesel	diesel
diät	diet
dietetically	dietetically
diets	diets
verschieden	annerledes
schwierigkeiten	vanskeligheter
schwierigkeit	difficulty
ausgraben	dig
digested	digested
dignitaries	dignitaries
dignities	dignities
würde	dignity
erweitern	utvide
dilated	dilated
doktor	lege
doeuvre	doeuvre
hund	hund
doggie	doggie
dogs	dogs
saufen	drikke
drinks	drinks
anfeuern	kjøre
drizzle	drizzle
trocken	tørke
ente	and
jede	hver
adler	ørn
eagles	eagles
eaglet	eaglet
ohr	øre
earache	earache
eardrum	eardrum
eardrums	eardrums
earlobe	earlobe
früh	tidlig
erringen	oppnå/inntjene
earning	earning
earphones	earphones
earring	dobb
ohrring	earrings
ohren	ears
boden	jord
erdbeben	earthquake
earthquakes	earthquakes
earths	earths
regenwurm	earthworm
earthworms	earthworms
earwax	earwax
ease	ease
arbeitsbock	easel
easier	lettere
leichteste	easiest
easily	easily
easiness	easiness
orient	øst
ostern	easter
leicht	easy
essen	spise
eatable	eatable
eats	spiser
ebony	ebony
eccentric	eccentric
eccentricity	eccentricity
geistlich	ecclesiastic
echo	ljome
eclipse	eclipse
ecologic	ecologic
ecologist	ecologist
ecology	ecology
economics	economics
ecru	ecru
acht	åtte
achtzehn	atten
eighteenth	attende
eightfold	eightfold
eighth	åttende
eighties	eighties
eightieth	eightieth
achtzig	åtti
eightyfold	eightyfold
einsteinium	einsteinium
jede	heller
ausrufen	ejaculate
ejaculated	ejaculated
ejaculates	ejaculates
ejaculating	ejaculating
ejaculation	ejaculation
ejaculations	ejaculations
ejaculatory	ejaculatory
eject	eject
ejectable	ejectable
ejecting	ejecting
ejection	ejection
ejector	ejector
ejectors	ejectors
elaborate	elaborate
elaborated	elaborated
elaborates	elaborates
elaborating	elaborating
ausarbeitung	elaboration
elaborations	elaborations
aufzug	heis
elf	elleve
eleventh	ellevte
ausschalten	fjerne
beschließen	ende
milieu	miljø
bote	envoy
beneiden	envy
beneiden	envy
rolltreppe	escalator
gründen	etablere
begebenheit	begivenhet
etwaig	eventual
gegebenfalls	eventuelt
ehemals	noen gang
evergreen	evergreen
endlos	everlasting
jede	hver
allenthalben	everywhere
eviction	eviction
erweis	evidence
ausrufen	exclaim
fabel	fable
fables	fables
gewebe	fabric
fabricant	fabricant
anfertigen	fabricate
fabricated	fabricated
fabricates	fabricates
fabricating	fabricating
fabrication	fabrication
fabrications	fabrications
fabricator	fabricator
fabricators	fabricators
fabrics	fabrics
fabulist	fabulist
fabulous	fabulous
fassade	facade
facades	facades
faceless	faceless
faceplate	faceplate
facet	facet
scherzhaft	facetious
scherzhaft	facetious
facetiously	facetiously
facial	facial
facies	facies
geläufig	facile
erleichtern	facilitate
facilitated	facilitated
facilitates	facilitates
facilitating	facilitating
möglichkeiten	facilities
hilfsmittel	hjelpemiddel
facing	facing
facsimile	facsimile
tatsache	faktum
fraktion	faction
factor	factor
fakultaet	factorial
factorials	factorials
factories	factories
factorization	factorization
factorizations	factorizations
factorize	factorize
factorized	factorized
factors	factors
fabrik	fabrikk
facts	fakta
faktisch	factual
facultative	facultative
facultatively	facultatively
faculties	faculties
fakultät	evne
fad	fad
erblassen	fade
faded	faded
fader	fader
faders	faders
fading	fading
faery	faery
faience	faience
unterlassen	fail
flau	besvime
faintly	faintly
basar	basar
ziemlich	temmelig
fee	fairy
gläubig	faithful
faithfully	faithfully
fashionable	fashionable
schnell	fort
fastener	fastener
wählerisch	fastidious
dick	tykk
fatal	fatal
fatalism	fatalism
fatality	fatality
fatally	fatally
bestimmung	fate
fischen	fisk
fishable	fishable
fishbowl	fishbowl
fished	fished
fisher	fisher
fisheries	fisheries
fisherman	fisherman
fishermen	fishermen
fishers	fishers
fishery	fishery
fishes	fishes
angeln	fishing
fishtail	fishtail
fission	fission
fissionable	fissionable
fissure	fissure
faust	neve
fisted	fisted
fistful	fistful
fünf	fem
fivefold	fivefold
anberaumen	fix
fixation	fixation
fixations	fixations
fixity	fixity
fixture	fixture
fixtures	fixtures
fjord	fjord
fjords	fjords
flug	flytur
diskette	floppy
fluently	fluently
fuß	fot
fußball	fotball
vergessen	glemme
vergeßlich	forgetful
forgetfulness	forgetfulness
forgivable	forgivable
forgivably	forgivably
entschuldigen	tilgi
forgiveness	tilgivelse
forgives	forgives
forgiving	forgiving
forgo	forgo
forgoes	forgoes
forgotten	forgotten
forlorn	forlorn
formaldehyde	formaldehyde
vier	fire
fuchs	rev
fractal	fractal
fractals	fractals
fraktion	fraction
fractionate	fractionate
fraternal	fraternal
fraternize	fraternize
freundin	venn
freundschaft	vennskap
fringe	fringe
frosch	frosk
frogs	frogs
als	fra
front	forside
fucked	fucked
fudge	fudge
fugue	fugue
fulgurant	fulgurant
angst	funk
funniest	funniest
drollig	morsom
gab	gab
gabardine	gabardine
gabber	gabber
gabbing	gabbing
gaberdine	gaberdine
hilfsmittel	gadget
freuen	gaiety
frohes	gaily
errungenschaft	oppnå/vinne
gained	gained
gaining	gaining
gala	gala
galactic	galactic
galaxy	galaxy
brav	gallant
gallantly	gallantly
gallantry	gallantry
galleries	galleries
galerie	gallery
gallon	gallon
galopp	gallop
galloped	galloped
galloping	galloping
galvanic	galvanic
galvanism	galvanism
galvanize	galvanize
galvanized	galvanized
aufführung	spill
spiels	games
knoblauch	hvitløk
gas	gass
benzin	bensin
ghostwriter	ghostwriter
angebinde	gave
gifts	gaver
fahren	gå
ziel	mål
ziel	goals
ziege	geit
gott	gud
goddess	goddess
goddesses	goddesses
gevatter	godfather
bucht	golf
golfer	golfer
golfers	golfers
golfs	golfs
gut	godt
gut	godt
adieu	farvel/på gjensyn
goodnight	goodnight
gopher	gopher
kleid	kjole
greifen	grab
gradient	gradient
allmählich	gradually
grammatik	grammar
traube	drue
die grapefruit	grapefrukt
habilitated	habilitated
habilitation	habilitation
angewohnheit	bruk
habitant	habitant
habitants	habitants
habitat	habitat
hausen	habitation
habitual	habitual
hatte	hadde
einhändigen	hånd
führen	hode
heats	heats
himmel	himmel
schwer	tung
hectare	hectare
hectares	hectares
hectoliter	hectoliter
igel	hedgehog
heed	heed
ferse	hæl
heeler	heeler
heels	heels
höhe	høyde
hielt	held
helices	helices
dschehenna	hell
hello	hallo
lenkrad	ratt
helm	helmet
hilfe	hjelpe
hanf	hemp
huhn	høne
herd	herd
hierher	her
reiher	heron
hips	hips
hauen	treff
hockey	hockey
hogwash	hogwash
holidayer	holidayer
holidays	holidays
nach hause	hjem
homeless	homeless
heim	homes
haus	hus
eis	is
instancing	instancing
internship	internship
jab	jab
jabber	jabber
jabberwocky	jabberwocky
jabberwocky	jabberwocky
bube	jekk
schakal	jackal
jackals	jackals
jackass	jackass
jackdaw	jackdaw
jacke	jakke
jacke	jakke
jackknife	jackknife
jackpot	jackpot
strapazieren	jade
abgenutzt	jaded
jag	jag
uneben	jagged
gefängnis	fengsel
gefängnis	fengsel
jailbreak	jailbreak
jailed	jailed
jailer	jailer
jailing	jailing
jailor	jailor
jails	jails
jalopy	jalopy
konfitüre	syltetøy
konfitüre	syltetøy
jamb	jamb
jammed	jammed
jammed	jammed
jangle	jangle
der hausmeister	janitor
der hausmeister	janitor
jar	jar
jar	jar
jar	jar
jargon	jargon
jasmine	jasmine
jaundice	jaundice
jaunt	jaunt
jaunty	jaunty
javelin	javelin
kiefer	jaw
maul	jaws
eichelhäher	jay
jazz	jazz
jazzy	jazzy
eifersüchtig	skinnsyk
eifersucht	jealousy
jeer	jeer
jeer	jeer
gelee	jelly
die qualle	jellyfish
jeopardize	jeopardize
jeopardize	jeopardize
erschüttern	jerk
erschüttern	jerk
deutschem	jerry
jersey	jersey
jersey	jersey
scherzen	jest
hanswurst	jester
hanswurst	jester
jet	jet
jet	jet
jettison	jettison
jetty	jetty
gemme	juvel
jeweler	jeweler
jewelery	jewelery
jewelry	smykke
jewels	jewels
jib	jib
jib	jib
augenblick	jiffy
jig	jig
jigsaw	jigsaw
jihad	jihad
jilt	jilt
klimpern	jingle
klimpern	jingle
klimpern	jingle
jinx	jinx
nervosität	jitters
arbeit	arbeid
arbeit	arbeid
arbeit	arbeid
arbeitslos	jobless
jockey	jockey
jovial	jocular
jocund	jocund
jodhpur	jodhpur
jog	jog
jogging	jogging
verbinden	join
verbinden	join
joinable	joinable
joined	joined
joiner	joiner
joinery	joinery
fuge	ledd
fuge	ledd
fuge	ledd
gemeinsames	jointly
scherzen	spøk
scherzen	spøk
joked	joked
joker	joker
jokingly	jokingly
jokingly	jokingly
jolly	jolly
erschüttern	jolt
erschüttern	jolt
jonquils	jonquils
jostle	jostle
jot	jot
jot	jot
journal	avis
journal	avis
journalism	journalism
journalist	journalist
journalists	journalists
reise	reise
reise	reise
gemütlich	jovial
jovially	jovially
freude	fryd
joyful	joyful
joyless	joyless
joyously	joyously
jubelfeier	jubilee
richten	bedømme
richten	bedømme
judged	judged
urteil	judgement
judicial	judicial
judiciary	judiciary
judo	judo
kanne	krukke/gryte/potte
kanne	krukke/gryte/potte
kanne	krukke/gryte/potte
juggernaut	juggernaut
gaukeln	juggle
jongleur	juggler
jugular	jugular
saft	saft
juiceless	juiceless
juicier	juicier
juiciest	juiciest
juicy	juicy
jukebox	jukebox
bewegen	dreie
jumbo	jumbo
springen	hoppe
jumped	jumped
jumpy	jumpy
union	junction
union	junction
jungle	jungle
junior	junior
juniper	juniper
junk	junk
junk	junk
junk	junk
junk	junk
junkers	junkers
junkers	junkers
junkie	junkie
junkie	junkie
junkyard	junkyard
juridic	juridic
jurisdiction	jurisdiction
jurist	jurist
juror	juror
jurors	jurors
geschworene	jury
billig	kun
gerechtigkeit	justice
justified	berettiget
justify	justify
justly	justly
jut	jut
juvenile	juvenile
juxtapose	juxtapose
kohl	kale
kaleidescope	kaleidescope
kaleidoscope	kaleidoscope
kängeruh	kangaroo
karat	karat
karate	karate
kayak	kayak
kebab	kebab
kiel	keel
bewahren	beholde
keeps	keeps
andenken	minnesmerke
keg	keg
keg	keg
kennel	kennel
kennel	kennel
kerchief	kerchief
kern	kernel
kern	kernel
kern	kernel
kerosene	kerosene
ketchup	ketchup
kessel	kjele
schlüssel/taste	nøkkel
schlüssel/taste	nøkkel
schlüssel/taste	nøkkel
tastatur	tastatur
keyhole	keyhole
keying	keying
keynote	keynote
keypad	keypad
khaki	khaki
stampfen	kick
stampfen	kick
kickback	kickback
kicked	kicked
kicker	kicker
kickoff	kickoff
kicks	kicks
zicklein	unge
zicklein	unge
zicklein	unge
kiddies	kiddies
kiddies	kiddies
kiddies	kiddies
kidnap	kidnap
kidnaped	kidnaped
kidnaper	kidnaper
kidnaper	kidnaper
kidnapers	kidnapers
kidnaping	kidnaping
kidnapped	kidnapped
kidnapper	kidnapper
kidnappers	kidnappers
kidnapping	kidnapping
kidnappings	kidnappings
niere	nyre
kidneys	kidneys
kidneys	kidneys
kids	unger
kids	unger
ermorden	drepe
ermorden	drepe
killer	killer
killer	killer
killers	killers
killing	killing
killing	killing
killings	killings
killjoy	killjoy
herd	ovn
kilogramm	kilo
kilogram	kilogram
kilohertz	kilohertz
kiloliter	kiloliter
kilometer	kilometer
kilowatt	kilowatt
kilt	kilt
verwand	kin
freundlich	snill
freundlich	snill
freundlich	snill
kindergarten	kindergarten
kindergarten	kindergarten
kindergarten	kindergarten
kindergarten	kindergarten
kindhearted	kindhearted
kindhearted	kindhearted
kindheartedness	kindheartedness
zünden	kindle
zünden	kindle
kindlessly	kindlessly
kindlessly	kindlessly
kindliness	kindliness
kindliness	kindliness
kindly	vennligst
kindly	vennligst
kindly	vennligst
kindly	vennligst
freundlichkeit	kindness
freundlichkeit	kindness
kindred	kindred
kindred	kindred
freundlicher	venlige
freundlicher	venlige
könig	konge
königreich	kingdom
königreich	kingdom
kingdoms	kingdoms
eisvogel	kingfisher
kingly	kingly
kings	kings
kinky	kinky
kiosk	kiosk
kipper	kipper
küssen	kysse
küssen	kysse
küssen	kysse
küssen	kysse
kisses	kisses
kisses	kisses
bausatz	kit
bausatz	kit
küche	kjøkken
kitchenette	kitchenette
kitchens	kitchens
kitchenware	kitchenware
kitchenware	kitchenware
drachen	kite
kith	slektninger
kiting	kiting
kätzchen	kattunge
kittens	kittens
kitty	kitty
kiwi	kiwi
kiwi	kiwi
kleenex	kleenex
kleenex	kleenex
kleptomania	kleptomania
kleptomaniac	kleptomaniac
knack	knack
knack	knack
tornister	ryggsekk
kneten	knead
kneadable	kneadable
kneader	kneader
knie	kne
kneecap	kneecap
kneel	kneel
kneel	kneel
kneeling	kneeling
kneeling	kneeling
kneepad	kneepad
knelt	knelt
knelt	knelt
knickers	knickers
knickknack	knickknack
knickknack	knickknack
messer	kniv
messer	kniv
knifes	knifes
knifing	knifing
kämpe	knight
kämpe	knight
knighted	knighted
knighthood	knighthood
knightly	knightly
knights	knights
stricken	strikke
stricken	strikke
stricken	strikke
knitted	knitted
knitting	knitting
knitwear	knitwear
knives	knives
gefäß	knob
gefäß	knob
knobby	knobby
knobs	knobs
klopfen	banke
knockdown	knockdown
knockout	knockout
knoten	knot
knots	knots
knotted	knotted
knotty	knotty
kennen	kjenne
knower	knower
knowhow	knowhow
knowhow	knowhow
weiss	knowing
knowingly	knowingly
knowingly	knowingly
begriff	kunnskap
begriff	kunnskap
kundig	knowledgeable
known	kjent
weisst	knows
knuckle	knuckle
knuckle	knuckle
knucklebone	knucklebone
knuckles	knuckles
koala	koala
koala	koala
kosher	kosher
kraut	kraut
kraut	kraut
krauts	krauts
kudzu	kudzu
lab	lab
arbeiten	arbeid
arbeiter	arbeider
arbeiter	arbeider
laborers	laborers
spitze	kniplinger
laceration	laceration
lacerations	lacerations
fehlen	lack
lackadaisical	lackadaisical
bedienter	lackey
lacking	lacking
lackluster	lackluster
laconic	laconic
laconically	laconically
firnissen	lacquer
firnissen	lacquer
junge	lad
damen	damer
dame	dame
ladybird	ladybird
marienkäfer	ladybug
see	innsjø
lakes	innsjøer
lamm	lam
lambs	lambs
laminated	laminated
laminates	laminates
lampe	lampe
sprache	språk
lachen	le
ledern	lær
abreisen	forlate
pult	lectern
vortrag	forelesning
lektor	lecturer
regal	ledge
ledger	ledger
lee	lee
bein	ben
legal	legal
legality	legality
legalize	legalisere
legally	legally
legate	legate
legation	legation
legende	legend
legendary	legendary
legion	legion
epistel	brev
epistel	brev
epistel	brev
achten	som
hausen	leve
gern haben	kjærlighet
gern haben	kjærlighet
freier	elsker
glück	luck
lunch	lunsj
mutti	ma
mutti	ma
maam	maam
maam	maam
maam	maam
macabre	macabre
macabre	macabre
macabrely	macabrely
macadam	macadam
macadam	macadam
macadamize	macadamize
macadamize	macadamize
macadamized	macadamized
macadamized	macadamized
macadamizes	macadamizes
macadamizes	macadamizes
macadamizing	macadamizing
macaque	macaque
macaque	macaque
makkaroni	macaroni
macaronies	macaronies
macaroon	macaroon
macaw	macaw
mace	mace
macerate	macerate
macerated	macerated
maceration	maceration
macerations	macerations
maces	maces
machete	machete
machination	machination
machined	machined
machineries	machineries
maschinerie	machinery
machines	machines
machinist	machinist
machinists	machinists
machismo	machismo
macho	macho
macrocephalic	macrocephalic
macrocosm	macrocosm
macroeconomics	macroeconomics
macroevolution	macroevolution
macroevolutionary	macroevolutionary
macroinstruction	macroinstruction
macromolecular	macromolecular
macromolecule	macromolecule
macromolecules	macromolecules
macropathological	macropathological
macropathology	macropathology
macrophage	macrophage
macrophages	macrophages
macrophagic	macrophagic
macroprocessor	macroprocessor
macroscopic	macroscopic
macrosimulation	macrosimulation
macrostructure	macrostructure
maculate	maculate
maculated	maculated
maculates	maculates
maculation	maculation
maculations	maculations
irre	mad
irre	mad
frau	madam
madams	madams
maddened	maddened
made	laget
made	laget
mademoiselle	mademoiselle
mademoiselles	mademoiselles
meister	maestro
mafioso	mafioso
zeitung	blad
magie	magic
zauberer	magician
magicians	magicians
magistral	magistral
magistrally	magistrally
magistrature	magistrature
magma	magma
mir	meg
mead	mead
anger	meadow
anger	meadow
meadowland	meadowland
meadows	meadows
mager	meager
meagerly	meagerly
meagre	meagre
mehl	måltid
meals	meals
beabsichtigen	bety
sich schlängeln	meander
meaningless	meaningless
bedeutung	meanings
bedeutet	midler
fleisch	kjøtt
meats	meats
meatball	kjøttkake
meatballs	meatballs
mechaniker	mechanical
mechanician	mechanician
mechanism	mechanism
mechanisms	mechanisms
denkmünze	medal
medallion	medallion
medallions	medallions
mediatrice	mediatrice
mediatrix	mediatrix
medic	medic
medizinisch	medical
medically	medically
medicament	medicament
medicaments	medicaments
medicinal	medicinal
medizin	medisin
medicines	medicines
medico	medico
medicolegal	medicolegal
medics	medics
medieval	medieval
medievalist	medievalist
medievalists	medievalists
mediocre	middelmådig
mediocrity	mediocrity
erwägen	meditere
meditates	meditates
meditation	meditasjon
meditations	meditations
meditative	meditative
mittels	mellom
medlar	medlar
medley	medley
medleys	medleys
medulla	medulla
medusae	medusae
meek	meek
meekly	meekly
meekness	meekness
meerschaum	meerschaum
megabyte	megabyte
megabytes	megabytes
megacycle	megacycle
megahertz	megahertz
megalith	megalith
megalithic	megalithic
megalomania	megalomania
megalomaniac	megalomaniac
megalomaniacal	megalomaniacal
megaphone	megaphone
melancholia	melancholia
melancholic	melancholic
melange	melange
melodic	melodic
melodies	melodies
melodious	melodious
melodram	melodrama
melodramas	melodramas
melodramatic	melodramatic
melodie	melody
melone	melon
melons	melons
melted	melted
anhänger	member
members	members
membrane	membrane
membranes	membranes
membranous	membranous
memoir	memoir
memoirs	memoirs
memorable	memorable
memories	minner
memorize	memorize
memorized	memorized
männer	menn
bevorstehen	menace
menagerie	menagerie
menageries	menageries
menhir	menhir
meningitis	meningitis
meniscus	meniscus
menopause	menopause
menstrual	menstrual
menstruation	mens
menstruations	menstruations
mental	mental
mentality	mentality
menthol	menthol
nennen	nevne
menü	spisekart
meow	meow
meowing	meowing
meows	meows
mephitic	mephitic
mercantile	mercantile
mercantilism	mercantilism
mercenaries	mercenaries
mercenary	mercenary
händler	kjøpmann
merchants	merchants
quecksilber	mercury
barmherzigkeit	barmhjertighet
meridian	meridian
meridional	meridional
verdienen	fortjeneste
meritocracy	meritocracy
merits	merits
die meerjungfrau	mermaid
mermaids	mermaids
wohlgemut	lystig
auskunft	bud
mitteilungen	meldinger
messiahs	messiahs
messianic	messianic
ächzen	moan
moaned	moaned
moaning	moaning
moans	moans
moat	moat
moats	moats
mob	mob
äffen	mock
mocked	mocked
spott	mockery
modal	modal
mondschein	moonlight
elch	moose
naiv	naive
naively	naively
bloß	bar
name	navn
named	hete
nameless	nameless
zwar	nemlig
zwar	nemlig
names	names
national	national
nationalism	nationalism
nationalist	nationalist
angeboren	native
natürlich	natural
naturalize	naturalize
natürlich	selvfølgelig
neap	neap
beiläufig	i nærheten
näher	nærmere
unterlassen	forsømme
nachbar	nabo
neighbors	neighbors
garn	nettverk
networked	networked
netzwerk	networks
neun	ni
neunzehn	nitten
nineteenth	nittende
nineties	nineties
ninetieth	ninetieth
neunzig	nitti
ninetyfold	ninetyfold
ninth	niende
niobium	niobium
nip	dram
zitze	nipple
nipples	nipples
nips	nips
nirvana	nirvana
nitrate	nitrate
nitrated	nitrated
nitrates	nitrates
nitrating	nitrating
nitration	nitration
nitrations	nitrations
nitric	nitric
nitride	nitride
stickstoff	nitrogen
nitroglycerin	nitroglycerin
nitroglycerine	nitroglycerine
edel	adelig
adeliger	nobleman
noblemen	noblemen
edelmut	nobleness
keine	nobody
noctambulism	noctambulism
noctambulist	noctambulist
nocturn	nocturn
nocturnally	nocturnally
nu	nå
heutzutage	nowadays
noway	noway
noway	noway
oaf	oaf
oafishness	oafishness
eiche	eik
ruder	åre
oarsman	oarsman
oase	oasis
hafer	havre
eid	oath
oatmeal	oatmeal
obdurate	obdurate
obedience	obedience
folgsam	obedient
obelisk	obelisk
fett	obese
obesity	obesity
ozean	hav
ein	en
apfelsine	oransje
oranges	appelsiner
orbit	orbit
orbital	orbital
orbits	orbits
orchester	orkester
orchestral	orchestral
orchestras	orchestras
orchestrated	orchestrated
befehlen	bestille
ordered	ordered
organismus	organism
organisms	organisms
organist	organist
organists	organists
einrichtung	organisasjon
organizations	organisasjoner
einrichten	organize
organized	organized
organs	organs
orgasm	orgasm
orgasms	orgasms
orgies	orgies
orgie	orgy
orient	orient
orientable	orientable
orientation	orientation
orientations	orientations
oriented	orientert
orients	orients
orifice	orifice
orifices	orifices
orificial	orificial
ursprung	begynnelse
ursprünglich	original
originality	originality
originally	originally
originals	originals
origins	origins
ornamental	ornamental
ornithology	ornithology
orthodox	orthodox
orthodoxes	orthodoxes
orthogonal	orthogonal
schreiten	tempo
schreiten	tempo
pachyderm	pachyderm
stillen	pacific
pacifically	pacifically
pacification	pacification
pacifications	pacifications
pacificist	pacificist
pacifier	pacifier
pacifism	pacifism
pazifist	pacifist
pacify	pacify
pacify	pacify
packen	package
packen	package
packaged	packaged
packaged	packaged
packed	packed
bündel	pakke
packing	packing
pact	pact
pacts	pacts
block	pad
padding	padding
paddeln	paddle
paddock	paddock
vorhängeschloss	padlock
vorhängeschloss	padlock
padrone	padrone
paella	paella
pagan	pagan
pagans	pagans
pageant	pageant
pageantry	pageantry
paid	betalte
eimer	spann
schmerz	smerte
pained	pained
painful	painful
painful	painful
painfully	painfully
painstaking	painstaking
färben	male
färben	male
pinsel	paintbrush
maler	malerinne
painters	painters
bild	maleri
paints	paints
paar	par
schlafanzug	pajamas
genosse	pal
genosse	pal
palast	slott
palatable	palatable
palaver	palaver
blaß	blek
palette	palette
pall	pall
pallet	pallet
pallette	pallette
pallor	pallor
handfläche	palm
handfläche	palm
palpable	palpable
palpable	palpable
paltry	paltry
broschüre	pamphlet
pan	pan
panacea	panacea
panama	panama
fladen	pancake
der panda	panda
pandemonium	pandemonium
pane	pane
paneel	panel
paneling	paneling
panelling	panelling
pang	pang
panik	panikk
panik	panikk
panicky	panicky
panorama	panorama
stiefmütterchen	pansy
pant	pant
panther	panther
unterhose	underbukse
speisekammer	pantry
beinkleid	bukse
papa	papa
dokument	dokument/papir
broschüre	paperback
parameter	parameter
passer	passer
glut	lidenskap
passionately	passionately
passive	passiv
passivity	passivity
passwort	password
passwords	passwords
vergangenheit	forbi
pasta	pasta
pectorals	pectorals
befremdend	peculiar
penitence	penitence
penitences	penitences
penitency	penitency
penitent	penitent
pentadactyl	pentadactyl
pentadactylism	pentadactylism
pi	pi
pianist	pianist
pianistic	pianistic
ansicht	bilde
pictures	pictures
pastete	paj
pies	pies
schwein	gris
abteilung	avdeling
pigment	pigment
pigmentation	pigmentation
pigments	pigments
pigs	pigs
lotsen	pilot
pilots	pilots
pilule	pilule
föhre	furu
ananas	ananas
pineapples	pineapples
pines	pines
rosa	rosa
tasche	lomme
brieftasche	pocketbook
pocketbooks	pocketbooks
pockets	pockets
podium	podium
pogrom	pogrom
pogroms	pogroms
zeiger	pointer
pointillism	pointillism
pointillist	pointillist
pointilliste	pointilliste
pointillistic	pointillistic
vergiften	gift
giftig	poisonous
poisonousness	poisonousness
poisons	poisons
polar	polar
polarities	polarities
polarity	polarity
polarize	polarize
polarized	polarized
polemical	polemical
polemically	polemically
polemicize	polemicize
polizei	politi
polizist	politikonstabel
polizist	politikonstabel
polizist	politikonstabel
policemen	policemen
policemen	policemen
policemen	policemen
policewoman	policewoman
policewomen	policewomen
polize	politikk
polnisch	polish
polnisch	polish
artig	polite
politely	politely
politeness	politeness
politisch	political
politically	politically
politician	politikere
politicians	politicians
politik	politikk
polka	polka
pollutant	pollutant
pollute	pollute
polluted	polluted
polluter	polluter
pollution	pollution
polonium	polonium
poltergeist	poltergeist
polyandrous	polyandrous
polyandry	polyandry
gießen	pour
schmollen	furte
armut	poverty
pudern	pudder/pulver
powdery	powdery
gewalt	power
gewältig	sterk
powerless	powerless
powwow	powwow
practicability	practicability
gangbar	gjennomførbar
praktisch	practical
beten	pray
gebet	bønn
prayers	prayers
praying	praying
praying	praying
predigen	preach
predigen	preach
preacher	preacher
preacher	preacher
preachers	preachers
preachers	preachers
preaches	preaches
preaches	preaches
preachify	preachify
preaching	preaching
preaching	preaching
preaching	preaching
preachy	preachy
preachy	preachy
preamplifiers	preamplifiers
prearrange	prearrange
prearrange	prearrange
fürst	prins
princedom	princedom
princely	princely
princes	princes
fürstin	prinsesse
hauptsächlich	overlærer
hauptsächlich	overlærer
principalities	principalities
fürstentum	principality
besonders	principally
besonders	principally
principals	principals
grundsatz	principle
principles	principles
drucken	avtrykk
drucken	avtrykk
drucken	avtrykk
ausgedruckt	printed
drucker	printer
drucker	printer
priorities	priorities
priorities	priorities
priorität	priority
begründen	bevise
puls	puls
pulverizable	pulverizable
pulverizables	pulverizables
pulverization	pulverization
mahlen	pulverize
pulverized	pulverized
pulverizer	pulverizer
pulverizers	pulverizers
pulverizes	pulverizes
pulverizing	pulverizing
puma	puma
pumpen	pumpe
dringen	trykk
pushchair	pushchair
pushing	pushing
legen	put
putdown	putdown
putout	putout
putrefaction	putrefaction
wachtel	quail
quails	quails
quake	quake
art	kvalitet
qualm	qualm
qualms	qualms
menge	antall
disput	krangel
quarry	quarry
quartier	kvarter
quarterdeck	quarterdeck
quarterfinal	quarterfinal
königin	dronning
wunderlich	queer
erdrosseln	quell
quench	quench
querulous	querulous
anfrage	query
nachsuchung	quest
frage	spørsmål
queue	queue
schikanieren	quibble
geschwind	fort
quicklime	quicklime
flugs	kvikk
quicksand	quicksand
quecksilber	quicksilver
fromm	quiet
quieten	quieten
quietly	quietly
quill	quill
steppen	quilt
quirk	quirk
abdanken	quit
sehr	nokså
quote	quota
zitat	quotation
anführen	quote
r	r
rabbet	rabbet
rabbiner	rabbi
rabbinic	rabbinic
kaninchen	kanin
rabbits	rabbits
gesindel	rabble
rabid	rabid
tollwut	rabies
raccoon	raccoon
abkunft	race
racehorse	racehorse
racemic	racemic
racer	racer
races	races
rachis	rachis
rachitic	rachitic
rachitis	rachitis
racialism	racialism
racialist	racialist
racialistic	racialistic
racing	racing
racism	racism
racist	racist
arrak	rack
schläger	racket
schläger	racket
radar	radar
radars	radars
radio	radio
lesen	lese
lesbarkeit	readability
readable	readable
reader	reader
readers	readers
readership	readership
readership	readership
gern	readily
gern	readily
gern	readily
readiness	readiness
readiness	readiness
lesung	leser
lesung	leser
lesung	leser
readings	readings
readings	readings
readjust	readjust
readjusts	readjusts
readjusts	readjusts
readout	readout
readout	readout
readouts	readouts
reads	reads
bereit	klar
bereit	klar
bereit	klar
reaffirm	reaffirm
reaffirm	reaffirm
reaffirms	reaffirms
reaffirms	reaffirms
reagent	reagent
effektiv	virkelig
effektiv	virkelig
effektiv	virkelig
realisable	realisable
realism	realism
realist	realist
realistic	nøkternt
realistic	nøkternt
realistically	realistically
wahrheit	virkelighet
begreifen	forstå
tatsächlich	virkelig
reporter	reporter
abbilden	representerer
bitten	anmode
bitten	anmode
bitten	anmode
bahn	vei
roads	roads
roadwork	roadwork
freibeuter	robber
rotting	rotting
sabbat	sabbat
sabbat	sabbath
sabbatic	sabbatic
sabbatical	sabbatical
saber	saber
sabin	sabin
sable	sable
sabot	sabot
sabotage	sabotage
sabotaged	sabotaged
sabotages	sabotages
saboteur	saboteur
sabra	sabra
sabras	sabras
saccade	saccade
saccharin	saccharin
saccharine	saccharine
saccharose	saccharose
sacerdotal	sacerdotal
sacerdotally	sacerdotally
sachet	sachet
abdanken	sekk/veske
abdanken	sekk/veske
sackcloth	sackcloth
sacked	sacked
sackful	sackful
sacks	sacks
sakrament	sacrament
sacramental	sacramental
sacraments	sacraments
sacre	sacre
heilig	sacred
erbieten	sacrifice
sacrificed	sacrificed
sacrifices	sacrifices
sakrilegium	sacrilege
düster	bedrøvelig
sadden	sadden
sadder	sadder
saddest	saddest
sattel	sal
saddlebag	saddlebag
saddlebags	saddlebags
saddlebow	saddlebow
saddlecloth	saddlecloth
saddled	saddled
saddleless	saddleless
saddler	saddler
saddlery	saddlery
saddles	saddles
saddletree	saddletree
sadism	sadism
sadist	sadist
sadistic	sadistic
sadistically	sadistically
sadists	sadists
sadly	sadly
betrübnis	tristhet
safari	safari
sicher	sikker
safecracker	safecracker
safecracking	safecracking
safeguard	safeguard
safeguarded	safeguarded
safeguards	safeguards
safer	sikrere
safest	sikreste
sicherheit	trygghet
safflower	safflower
saffron	saffron
sag	sag
saga	saga
einsichtsvoll	sagacious
sagaciously	sagaciously
sagaciousness	sagaciousness
sagacity	sagacity
salbei	sage
sagely	sagely
sago	sago
saguaro	saguaro
sahib	sahib
sagte	sa
segel	sail
segel	sail
sailable	sailable
das segelboat	sailboat
sailboater	sailboater
sailcloth	sailcloth
sailors	sailors
sails	sails
sainfoin	sainfoin
heiliger	saint
sainted	sainted
sainthood	sainthood
saith	saith
sake	skyld
salability	salability
salacious	salacious
salat	salad
salads	salads
der salamander	salamander
salaried	salaried
salaries	salaries
absatz	salg
saleable	saleable
saleroom	saleroom
salesclerk	salesclerk
salesgirl	salesgirl
saleslady	saleslady
ladengehilfe	salesman
salesmanship	salesmanship
verkäufer	salesmen
salespeople	salespeople
salesperson	salesperson
salesroom	salesroom
ladenfräulein	saleswoman
saleswomen	saleswomen
salient	salient
saline	saline
salinity	salinity
salinometer	salinometer
salinometers	salinometers
speichel	saliva
salivary	salivary
salivate	salivate
salivated	salivated
salivates	salivates
salivating	salivating
salivation	salivation
sallies	sallies
blaß	blek
sallowish	sallowish
lachs	laks
salmons	salmons
aula	sal
salons	salons
salzen	salt
saltwater	saltwater
saltworks	saltworks
saltwort	saltwort
salzen	salty
bekömmlich	salubrious
salubrity	salubrity
heil	salvage
salver	salver
samba	samba
gleiche	samme
sampan	sampan
samphire	samphire
samurai	samurai
samurais	samurais
sand	sand
sandale	sandal
schule	skole
meer	sjø
veräußern	selge
seller	seller
sellers	sellers
serendipity	serendipity
heiter	serene
sieben	sju
sevenfold	sevenfold
siebzehn	sytten
seventeenth	søttende
seventh	sjuende
seventies	seventies
seventieth	seventieth
siebzig	sytti
seventyfold	seventyfold
sever	sever
streng	severe
severed	severed
severely	severely
severities	severities
severity	severity
sewage	sewage
geschlecht	sex
sexagenarian	sexagenarian
generisch	sexual
sexually	sexually
shades	shades
schatten	shadow
shadows	shadows
shagreen	shagreen
schah	shah
erschüttern	shake
shakedown	shakedown
shaken	shaken
shaky	shaky
shaman	shaman
shamanism	shamanism
shampoo	shampoo
shampoos	shampoos
hammel	sau
sheepherder	sheepherder
abfertigen	skip
abfertigen	skip
mist	drit
krank	syk
silber	sølv
singen	synge
berufssänger	singer
tauchen	vask
sechs	seks
sechzehn	seksten
sixteenth	sekstende
sixties	sixties
sechzig	seksti
sixtyfold	sixtyfold
ausdehnung	størrelse
rochen	skate
skateboard	skateboard
skateboarder	skateboarder
skateboarding	skateboarding
skateboards	skateboards
skater	skater
skaters	skaters
skates	skates
skating	skating
geschicklichkeit	skill
geübt	skilled
skilless	skilless
geübt	skillful
himmel	himmel
lerche	skylark
skyscraper	skyscraper
snout	snout
schneien	snø
snowball	snowball
schneeflocke	snowflake
snowman	snowman
snowstorm	snowstorm
software	programvare
sorrily	sorrily
betrübnis	sorg
abart	sortere
sorted	sorted
sorter	sorter
gemüt	sjel
spectra	spectra
spectrum	spectrum
speculate	speculate
speculation	speculation
klammer	staple
stapled	stapled
die heftmaschine	stapler
staplers	staplers
staples	staples
stern	stjerne
stars	stars
anstellen	begynne
stifled	stifled
stärke	kraft
blödsinnig	dum
subjekt	subject
erfolg haben	succeed
erfolg	fremgang
sonne	sol
sunbathe	sunbathe
sonnig	sunny
suppressed	suppressed
argwöhnen	suspect
lästern	banne
tab	tab
tab	tab
tabernacle	tabernacle
tabelle	bord
tableau	tableau
tableaus	tableaus
tableaux	tableaux
tischtucher	tablecloth
tablecloths	tablecloths
tables	tables
tabelle	tablet
tablets	tablets
taboos	taboos
tachometer	tachometer
tachometers	tachometers
tacit	tacit
sterz	hale
schneidern	skredder
tailored	tailored
tailors	tailors
frack	tails
arbeit	task
angaben	tasks
schmecken	smak
tasted	tasted
fade	tasteless
zerreißen	tear
zerreißen	tear
zerreißen	tear
zerreißen	tear
teardrop	teardrop
tearful	tearful
tearfully	tearfully
tearfully	tearfully
teargas	teargas
tearjerker	tearjerker
tearless	tearless
tearless	tearless
tearoom	tearoom
tränen	tears
tränen	tears
tearstained	tearstained
tearstained	tearstained
tease	tease
tease	tease
tease	tease
teasel	teasel
teaser	teaser
teaser	teaser
teases	teases
teases	teases
teases	teases
teasing	teasing
teasing	teasing
teasingly	teasingly
teasingly	teasingly
teaspoon	teaspoon
teaspoon	teaspoon
teaspoonful	teaspoonful
brust	teat
brust	teat
brust	teat
brust	teat
teatime	teatime
teats	teats
teats	teats
zehn	ti
tendencies	tendencies
stimmung	tendens
tenderfoot	tenderfoot
zärtlich	tenderly
daher	thence
daher	thence
thenceforth	thenceforth
thenceforward	thenceforward
theocracy	theocracy
theocratic	theocratic
theodolite	theodolite
theologe	theologian
theologians	theologians
theological	theological
theologically	theologically
theologie	theology
theorem	theorem
theorems	theorems
theoretical	theoretical
theoretical	theoretical
theoretically	theoretically
theoretician	theoretician
theoretician	theoretician
theoreticians	theoreticians
theoreticians	theoreticians
theorist	theorist
theorist	theorist
theorists	theorists
theorists	theorists
theorize	theorize
dieb	tyv
obgleich	though
obgleich	though
gedanke	tanke
gedanke	tanke
thoughtful	omtenksomt
thoughtfully	thoughtfully
vorsorge	thoughtfulness
thoughtless	thoughtless
thoughtlessly	thoughtlessly
thoughtlessness	thoughtlessness
tausend	tusen
thousandth	thousandth
verhauen	thrash
verhauen	thrash
faden	tråd
faden	tråd
faden	tråd
threadbare	threadbare
bedrohung	threat
bevorstehen	threaten
threatening	threatening
threateningly	threateningly
drei	tre
tigress	tigress
heute	i dag
zehe	tå
tradition	tradition
traditionell	tradisjonell
geleise	trail
abrichten	tog
trainee	trainee
trainer	trainer
traitor	traitor
transaction	transaksjon
transalpine	transalpine
transcribe	transcribe
entern	overføring
übersetzen	oversette
übersetzung	oversettelse
übersetzer	translator
schicken	sende
baum	tre
lastauto	lastebil
zwei	to
ubiquitous	ubiquitous
ubiquity	ubiquity
euter	udder
ugh	æsj
uglier	uglier
ugliest	ugliest
uglify	uglify
uglily	uglily
ugliness	ugliness
häßlich	heslig
ukulele	ukulele
geschwür	ulcer
ulcerate	ulcerate
ulcerated	ulcerated
ulceration	ulceration
ulcerative	ulcerative
ulna	ulna
ultimo	ultimo
arbeitlosigkeit	arbeidsløshet
vacant	ledig
vacate	vacate
ferien	ferie
impfen	vaccinate
vaccinated	vaccinated
vacuum	vacuum
vacuumed	vacuumed
vagina	vagina
vagrant	vagrant
vague	vague
vergebens	vain
wacky	wacky
wag	wag
walnuß	walnut
geschäft	varehus
geschäft	varehus
warehouses	warehouses
spülen	vaske
tränen	weep
weeping	weeping
weeping	weeping
weeps	weeps
weepy	weepy
weepy	weepy
weevil	weevil
weft	weft
wägen	weigh
wägen	weigh
weighing	weighing
weighings	weighings
weighs	veier
gewicht	vekt
weighted	weighted
weighted	weighted
weightily	weightily
weighting	weighting
weighting	weighting
weightless	weightless
gewichtslosigkeit	weightlessness
weights	weights
weights	weights
schwer	weighty
schwer	weighty
weir	weir
seltsam	merkelig
weirdie	weirdie
weirdies	weirdies
weirdly	weirdly
weirdness	weirdness
weirdness	weirdness
weirdo	weirdo
weirdos	weirdos
weirs	weirs
willkommen	velkommen
willkommen	velkommen
willkommen	velkommen
willkommen	velkommen
war	hvor
fenster	vindu
fenster	vindu
windowpane	windowpane
windowpanes	windowpanes
windows	windows
windstorm	windstorm
wein	vin
wineglass	wineglass
winegrower	winegrower
winemaker	winemaker
winemaking	winemaking
winepress	winepress
wines	wines
winey	winey
fittich	vinge
winglet	winglet
zwinkern	wink
winter	vinter
wischen	wipe
draht	ståltråd
draht	ståltråd
draht	ståltråd
wired	wired
radio	wireless
wiring	wiring
wiry	wiry
weisheit	visdom
gescheit	vis
wisecrack	wisecrack
wisely	wisely
wiser	wiser
wünschen	ønske
wünschen	ønske
wishbone	wishbone
wünsche	wishes
wishful	wishful
hexe	heks
witches	witches
mit	med
zurückziehen	withdraw
zurückziehen	withdraw
ohne	uten
zeuge	witness
zeuge	witness
witnesses	witnesses
wolverine	wolverine
wolverine	wolverine
welt	verden
universal	worldwide
xenophobe	xenophobe
xenophobia	xenophobia
xenophobic	xenophobic
xerographic	xerographic
xylem	xylem
xylene	xylene
xylophone	xylophone
xylophones	xylophones
xylophonist	xylophonist
xylose	xylose
xylotomic	xylotomic
jacht	yacht
yachting	seiling
yachtsman	yachtsman
yak	yak
yamswurzel	yam
yap	yap
hof	tun
yardstick	yardstick
yarn	yarn
gähnen	yawn
gähnen	yawn
yawning	yawning
ja	yeah
jahr	år
yearbook	yearbook
yearlong	yearlong
jährlich	yearly
jährlich	yearly
sich ersehnen	yearn
yearning	yearning
yearningly	yearningly
jahr	years
yeast	yeast
heulen	yell
heulen	yell
gelb	gul
yellowed	yellowed
yellowing	yellowing
yellowish	yellowish
ja	ja
gestern	igår
noch	ennå
yew	yew
abtreten	yield
yoga	yoga
yoghurt	yoghurt
yogurt	yogurt
joch	åk
yolk	yolk
du/sie	du/deg/ni
du/sie	du/deg/ni
jung	ung
jüngere	yngre
jüngling	youngster
jugend	ungdom
youthful	youthful
yuppie	yuppie
zabaglione	zabaglione
zany	zany
zazen	zazen
eifer	iver
eifrig	zealous
zebra	zebra
zenit	zenith
null	null
null	null
zest	zest
im zickzack gehen	zigzag
zink	zinc
reissverschluss	glidelås
tierkreis	zodiac
tierkreis	zodiac
zone	sone
zone	sone
zoo	dyrehave
zoologie	zoology
zoom	zoom
zucchini	zucchini
