ein	à
ein	à
aardvark	aardvark
aardvark	aardvark
aardvarks	aardvarks
zurück	aback
zurück	aback
zurück	aback
abacterial	abacterial
abacus	abaque
abacus	abaque
abacus	abaque
abacuses	abacuses
abacuses	abacuses
abacuses	abacuses
abaft	abaft
abalone	abalone
abalones	abalones
ablassen	abandonner
ablassen	abandonner
impertinent	immoral
impertinent	immoral
impertinent	immoral
abandonee	abandonee
abandoner	abandoner
abandoning	abandoning
zession	abandonment
zession	abandonment
abandonments	abandonments
demütigen	humilier
abased	abased
abasement	abasement
abasements	abasements
abases	abases
beschämen	abash
verlegen	abashed
verlegen	abashed
abasing	abasing
erschlaffen	diminuer
erschlaffen	diminuer
abated	abated
nachlaß	rabais
nachlaß	rabais
abatements	abatements
abates	abates
abating	abating
abating	abating
abattoir	boucherie
abbe	abbe
abberations	abberations
abtei	abbaye
abtei	abbaye
abbeys	abbeys
abt	abbé
abt	abbé
abt	abbé
abt	abbé
abt	abbé
abbots	abbots
abkürzen	raccourcir
abkürzen	raccourcir
abbreviated	abbreviated
abbreviates	abbreviates
abbreviating	abbreviating
verkürzung	abbreviation
verkürzung	abbreviation
verkürzung	abbreviation
verkürzungen	abbreviations
verkürzungen	abbreviations
abbreviator	abbreviator
abdicable	abdicable
abdanken	abdiquer
abdanken	abdiquer
abdicated	abdicated
abdication	abdication
abdicator	abdicator
hinterleib	abdomen
hinterleib	abdomen
abdomens	abdomens
den unterbauch betreffend	abdominal
abdominally	abdominally
abduct	abduct
abducted	abducted
abducting	abducting
abduction	abduction
abductions	abductions
abductor	abducteur
abductors	abductors
quer	abeam
abecedarian	abecedarian
abed	abed
abweichung	aberrance
aberrant	aberrant
aberrantly	aberrantly
aberration	erreur
aberration	erreur
aberrations	aberrations
agitieren	agiter
mithilfe	abetment
abets	abets
abetted	abetted
abetter	abetter
abetting	abetting
abettor	abettor
ruhen	abeyance
abeyant	abeyant
verabscheuen	abominer
abhorred	abhorred
abscheu	abomination
abhorrent	abominable
abhorrently	abhorrently
abhorring	abhorring
abhors	abhors
gewärtigen	attendre
abided	abided
abides	abides
fest	permanent
abilities	abilities
kapazität	capacité
kapazität	capacité
abiotic	abiotic
gemein	lâche
abjection	abjection
abjectly	abjectly
abjuration	abjuration
annullieren	abjurer
abjurer	abjurer
ablation	ablation
ablativ	ablatif
ablaze	ardant
ablaze	ardant
begabt	apte à
begabt	apte à
begabt	apte à
begabt	apte à
abler	abler
ablest	ablest
abloom	abloom
ablution	ablution
ablutions	ablutions
ably	ably
abnegate	agir avec abnégation
abnegates	abnegates
aufopferung	abnegation
abnormal	abnormal
abnormal	abnormal
abnormal	abnormal
abnormalities	abnormalities
abnormalität	abnormality
abnormally	abnormally
an bord	aboard
wohnort	domicile
abodes	abodes
aboil	aboil
annullieren	abolir
annullieren	abolir
abolishable	abolishable
abolished	abolished
abolisher	abolisher
abolishes	abolishes
abolishment	abolishment
abolition	abolition
abolition	abolition
abolitionism	abolitionism
abolitionist	abolitionist
abolitionists	abolitionists
abscheulich	abominable
abominably	abominably
verabscheuen	abominer
abscheu	abomination
abominations	abominations
eingeboren	aborigène
aboriginally	aboriginally
aborigine	aborigine
aborigines	aborigines
abortieren	avorter
aborted	aborted
aborter	aborter
aborting	aborting
fiasko	avortement
fiasko	avortement
abortionist	avorteur
abortionists	abortionists
abortions	abortions
nutzlos	inutile
abortively	abortively
aborts	aborts
schwärmen	abonder
betreffs	concernant
oberhalb	au-dessus de
aboveboard	aboveboard
aboveground	aboveground
abovementioned	abovementioned
abovementioned	abovementioned
abracadabra	abracadabra
abradable	abradable
hobeln	abrade
abrasion	abrasion
abrasions	abrasions
grell	acéré
abrasives	abrasives
abreast	abreast
begrenzen	limiter
abridged	abridged
übersicht	réduction de texte
abridging	abridging
äußerlich	à l'étranger
annullieren	abolir
abrogated	abrogated
abrogation	abolition
abgerissen	abrupt
abruptly	abruptement
abruptness	abruptness
abszeß	abcès
abscesses	abscesses
ausreißen	s'enfuir
absconded	absconded
abwesenheit	absence
absences	absences
abwesend	absent
abwesend	absentee
absenteeism	absenteeism
absentees	absentees
abwesend	absently
absentminded	absentminded
absentmindedly	absentmindedly
absentmindedly	absentmindedly
absentmindedness	absentmindedness
beifuß	absinthe
beifuß	absinthe
absolut	absolu
freilich	absolument
begnadigung	absolution
absolutismus	absolutisme
absolvieren	absoudre
absolved	absolved
absolving	absolving
absorbieren	absorber
absorbability	absorbability
absorbable	absorbable
absorbant	absorbant
absorbed	absorbed
absorbent	absorbant
absorbing	absorbing
absorption	absorption
abstain	faire abstinence
abstained	abstained
abstinent	sobre
abstinenz	abstention
abstentions	abstentions
abstinenz	abstinence
abstinent	abstinent
abstinently	abstinently
abstrakt	abstrait
abstrakt	abstrait
diebstahl	abstraction
geheimnissvoll	mystérieux
abgeschmackt	absurde
absurdism	absurdism
absurdist	absurdist
absurdities	absurdities
verdrehtheit	absurdité
reichtum	abondance
reichlich	abondant
im überfluß	abondamment
beleidigen	insulter
abused	abused
anzüglich	abusive
abusively	abusively
abut	abut
abuzz	abuzz
unerforschlich	terrible
abysmally	abysmally
abgrund	abîme
abgrund	abîme
abysses	abysses
abysses	abysses
akazie	acacia
student	académique
academical	academical
academically	academically
academician	académicien
academies	academies
academism	academism
akademie	académie
akanthus	acanthe
acanthuses	acanthuses
beipflichten	adhérer
beipflichten	adhérer
beeilen	accélerer
accelerated	accelerated
acceleration	accélération
accelerations	accelerations
accelerator	accélérateur
accelerators	accelerators
accelerometer	accelerometer
accelerometers	accelerometers
accent	accentuer
betonte	accented
betonte	accented
accents	accents
accentual	accentual
accentually	accentually
betonen	accentuer
accentuated	accentuated
accentuation	accentuation
annehmen	accepter
acceptability	acceptability
acceptable	acceptable
acceptably	acceptably
annahme	accueil
accepted	accepté
accepter	accepter
acceptor	accepteur
anfall	accès
accessed	accessed
accessibility	accessibility
zugänglich	sensible
errungenschaft	acquisition
accessorial	accessorial
zubehör	accessories
accessorize	accessorize
accessors	accessors
accessory	accessoire
unfall	accident
zufällig	accidental
accidentalism	accidentalism
accidentalist	accidentalist
accidentally	accidentally
accidently	accidently
accidents	accidents
akklamieren	acclamer
beifall	acclamation
acclimate	acclimate
acclimated	acclimated
akklimatisieren	acclimatize
accolade	accolade
accolades	accolades
adaptieren	adapter
accommodated	accommodated
entgegenkommend	accommodating
einrichtung	accomodation
accommodations	accommodations
accompanied	accompanied
accompanier	accompanier
accompanies	accompanies
geleit	accompagnement
accompaniments	accompaniments
gefährte	cavalier
accompanists	accompanists
begleiten	accompagner
accompanyist	accompanyist
accompanyists	accompanyists
accomplice	accomplice
accomplices	accomplices
erlangen	atteindre
accomplished	accomplished
accomplishment	accomplishment
accomplishments	accomplishments
akkord	accord
accordance	accordance
accorder	accorder
accorders	accorders
ziehharmonika	accordéon
accordionist	accordéoniste
accordionists	accordionists
accordions	accordions
accords	accords
ansprechen	accost
konto	compte
accountability	accountability
accountable	accountable
buchrevisor	accountant
buchführung	accounting
accouterment	accouterment
accrued	accrued
accruement	accruement
accumulated	accumulated
acetaminophen	acetaminophen
acetify	acetify
acetone	acetone
herb	acide
acidic	acidic
allergen	allergen
allergen	allergen
allergic	allergic
allergies	allergies
allergies	allergies
allergie	allergy
allergie	allergy
alleviate	alleviate
alleviated	alleviated
gasse	ruelle
gasse	ruelle
alleys	alleys
alleys	alleys
verbindlichkeit	alliance
verbindlichkeit	alliance
alliances	alliances
alliances	alliances
allied	allied
allied	allied
alligator	alligator
alligator	alligator
alligators	alligators
alligators	alligators
alliteration	alliteration
alliteration	alliteration
alliterations	alliterations
alliterations	alliterations
allocate	allocate
allocated	allocated
allocation	allocation
allocation	allocation
allocations	allocations
allocution	allocution
allocution	allocution
allocution	allocution
verlosen	allot
lassen	laisser
zulässig	allowable
erlaubnis	allowance
erlaubt	allowed
legierung	alliage
alphabet	alphabet
alphabetic	alphabetic
alphabetical	alphabetical
alphabetization	alphabetization
alphabetizations	alphabetizations
alphabetize	alphabetize
alphabetized	alphabetized
alphabetizing	alphabetizing
alphabets	alphabets
alphamerical	alphamerical
alphanumerisch	alphanumeric
alphanumerical	alphanumerical
alphanumerically	alphanumerically
alphanumerics	alphanumerics
alpine	alpine
alpinism	alpinism
alpinist	alpinist
bereits	déjà
auch	aussi
altercation	altercation
altercations	altercations
sich ablösen	alterner
alternated	alternated
alternately	alternately
unter	entre
amoral	amoral
amorous	amorous
amorously	amorously
amorph	amorphous
anzahl	nombre
anzahl	nombre
amp	amp
ampère	ampere
ampersand	ampersand
amphetamine	amphetamine
und	et
anyway	anyway
irgendwo	quelque part
aorta	aorta
schnell	apace
abgesondert	particulier
apartheid	apartheid
appartement	appartement
indolent	apathetic
apathie	apathie
affe	singe
affe	singe
aperitif	aperitif
öffnung	orifice
spitze	apex
aphid	aphid
eintreffen	arriver
espe	aspen
kontrollieren	vérifier
auditorium	auditorium
auditoriums	auditoriums
audits	audits
verfügbar	available
quasseln	babble
babbler	babbler
babies	babies
pavian	babouin
kinder	bébé
baccalaureate	baccalaureate
baccarat	baccarat
hagestolz	célibataire
bachelors	bachelors
bacilli	bacilli
bacillus	bacillus
rücken	dos
backache	backache
backbite	backbite
wirbelsäule	backbone
hintergrund	arrière-plan
backgrounds	backgrounds
after	derrière
backslide	backslide
backup	backup
backward	backward
speck	lard
bakterien	bacteria
böse	mal
insignien	insigne
badged	badged
badgers	badgers
badinage	badinage
beutel	bag
lapalie	bagatelle
bagatelles	bagatelles
bagage	colis
bags	bags
baguette	baguette
bah	bah
bail	bail
köder	bait
backen	faire cuire au four
bäcker	boulanger
bakeries	bakeries
bakers	bakers
bäckerei	boulangerie
bakeshop	bakeshop
saldo	reliquat
balconies	balconies
altan	balcon
kahlköpfig	chauve
baldhead	baldhead
baldly	baldly
baldness	baldness
bale	bale
baleen	baleen
hindern	balk
ball	bal
ballade	ballad
ballade	ballade
ballads	ballads
ballast	ballast
ballett	ballet
balletic	balletic
ärostat	aérostat
ballot	ballot
balls	balls
ballyhoo	ballyhoo
balsam	beaume
bambus	bamboo
betrügen	bamboozle
banane	banane
bananas	bananas
bande	bande
bandage	bandage
bandeau	bandeau
bandit	bandit
bandits	bandits
bandleader	bandleader
bandmaster	bandmaster
bane	bane
banished	banished
barb	barb
barbar	barbarian
barbarians	barbarians
barbarismus	barbarism
barbier	coiffeur
barmaid	barmaid
barman	barman
kaserne	caserne
strand	plage
aushalten	faire naître
aushalten	faire naître
beet	planche
schlafzimmer	chambre à coucher
glauben	croire
verraten	trahir
bibliographic	bibliographic
bibliographies	bibliographies
bibliographie	bibliography
brombeere	blackberry
buch	livre
boomerang	boomerang
boxer	boxer
junge	garçon
boys	boys
gehirn	cerveau
brood	brood
besen	balai
broth	broth
bauen	construire
anbau	construction
adieu	adieu
droschke	cab
cabal	cabal
cabala	cabala
cabalism	cabalism
cabalist	cabalist
cabalistic	cabalistic
caballero	caballero
cabaret	cabaret
kohl	chou
cabbages	cabbages
cabdriver	cabdriver
hütte	cabane
kabinett	armoire
cabinetmaker	cabinetmaker
cabinetmakers	cabinetmakers
cabinets	cabinets
cabins	cabins
kabel	câble
cabled	cabled
cablegram	cablegram
cablegrams	cablegrams
cables	cables
cabling	cabling
chauffeur	cabman
caboose	caboose
cabotage	cabotage
cabriolet	cabriolet
cabs	cabs
cacao	cacao
cacciatore	cacciatore
cachalot	cachalot
cache	cache
cachepot	cachepot
caches	caches
cackle	cackle
cackled	cackled
cackles	cackles
cackling	cackling
cacophony	cacophony
cacti	cacti
kaktus	cactus
cad	cad
kadaver	cadavre
cadaverous	cadaverous
caddies	caddies
caddy	caddy
cadence	cadence
cadet	cadet
cadetship	cadetship
cadge	cadge
cadger	cadger
cafe	cafe
cafes	cafes
cafeteria	cafeteria
cafeterias	cafeterias
caffeine	caffeine
kaftan	caftan
bauer	cage
cages	cages
cahier	cahier
cairn	cairn
cairns	cairns
caitiff	caitiff
cajole	cajole
cajoler	cajoler
cajolery	cajolery
kuchen	gâteau
kuchen	gâteau
kalcium	calcium
erachten	calculer
calculated	calculated
calibrieren	calibrate
calibrated	calibrated
calibration	calibration
auto	auto
carbonization	carbonization
carbonize	carbonize
carbonized	carbonized
carbonless	carbonless
carburetor	carburetor
carburetors	carburetors
carburization	carburization
carburize	carburize
karte	carte
cardamom	cardamom
cardiac	cordial
cardigan	cardigan
cardioid	cardioid
cardioids	cardioids
sorge tragen	avoir soin de
sorge tragen	avoir soin de
cared	cared
karriere	career
bedächtig	prudent
sorgfältig	carefully
katze	mégère
karzer	cachot
cellular	cellular
zufällig	hasard
die kirschen	cherries
kirche	église
churches	churches
mantel	manteau
cloaks	cloaks
uhr	horloge
clockmaker	clockmaker
clockwise	clockwise
cloister	cloister
clone	clone
wolke	nuage
clouds	clouds
kohle	charbon
computer	ordinateur
computers	computers
comrades	comrades
concealed	concealed
conjuring	conjuring
contemplate	contempler
contemplate	contempler
contemplate	contempler
contemplates	contemplates
contemplation	contemplation
contemplation	contemplation
contemplation	contemplation
contemplations	contemplations
contemplations	contemplations
contemplative	contemplative
contemporaneous	contemporaneous
contemporaneously	contemporaneously
contemporaries	contemporaries
contemporaries	contemporaries
zeitgenössisch	contemporary
zeitgenössisch	contemporary
verachtung	contempt
verachtung	contempt
contemptible	contemptible
contemptibly	contemptibly
contemptuous	contemptuous
contemptuous	contemptuous
contemptuously	contemptuously
contemptuously	contemptuously
contend	contend
contend	contend
contend	contend
contender	contender
contender	contender
contender	contender
contenders	contenders
contenders	contenders
contenders	contenders
contending	contending
contending	contending
contends	contends
contends	contends
inhalt	content
inhalt	content
inhalt	content
zufrieden	content
zufrieden	content
contentedly	contentedly
contentedness	contentedness
contention	contention
contention	contention
contention	contention
contentions	contentions
contentions	contentions
contentions	contentions
contentious	contentious
contentious	contentious
contentment	contentment
inhalt	contenu
inhalt	contenu
konkurrenz-prüfung	concours
konkurrenz-prüfung	concours
konkurrenz-prüfung	concours
contestant	contestant
contestant	contestant
kinderbett	cot
coterie	coterie
cotillion	cotillion
cotillon	cotillon
häuschen	cottage
cottager	cottager
couch	canapé
husten	tousser
coughs	coughs
rechne	comte
angesicht	countenance
counteract	counteract
counterbalance	counterbalance
countermand	countermand
countermarch	countermarch
counterplot	counterplot
counterpoint	counterpoint
counterpoise	counterpoise
counterweight	counterweight
countess	countess
zahllos	countless
gefilde	campagne
countryman	paysan
countrywide	countrywide
county	county
ehepaar	couple
couplet	couplet
coupon	coupon
mut	courage
beherzt	courageux
courageously	courageously
courier	courier
kurs	piste
courser	courser
den hof machen	cour
artig	courtois
courteously	courteously
courteousness	courteousness
courtesy	courtesy
courthouse	courthouse
courtier	courtier
courtliness	courtliness
courtly	courtly
courtmartial	courtmartial
gericht	courtroom
courtship	courtship
base	cousine
cove	cove
vereinbarungen	covenant
einband	couvrir
covert	covert
gelüsten	covet
covetous	covetous
covetously	covetously
kuh	vache
kuh	vache
coward	peureux
cowardice	faiblesse
cowardly	cowardly
kauern	être accroupi
cowherd	cowherd
kappe	cowl
coxcomb	coxcomb
coy	coy
coyly	coyly
coyness	coyness
coyote	coyote
cozily	cozily
cozy	cozy
crabapple	crabapple
crabbed	crabbed
spalte	craquer
cracker	cracker
knistern	crackle
wiege	cradle
craft	craft
craftily	craftily
crag	crag
cram	cram
cramp	cramp
cranberry	cranberry
kranich	grue
cranium	cranium
crankiness	crankiness
cranky	cranky
crape	crape
crash	crash
crate	crate
crater	crater
crave	crave
feig	craven
kriechen	ramper
krebs	écrevisse
buntstift	crayon
wut	craze
crazily	crazily
irre	fou
fletschen	grincer
rahm	crème
creamy	creamy
zerknittern	froisser
schaffen	créer
creation	creation
creator	creator
gebilde	créature
credence	credence
credential	lettre de créance
kredit	credit
creditable	creditable
creditably	creditably
gläubiger	creditor
credo	credo
credulity	credulity
leichtgläubig	credulous
credulously	credulously
creed	creed
creek	creek
kriechen	ramper
creeps	creeps
brennen	cremate
mähen	faucher
süss	cute
süss	cute
cuteness	cuteness
cutoffs	cutoffs
cutout	cutout
schneidet	cuts
cutter	cutter
cutting	cutting
cyanate	cyanate
cyanide	cyanide
cybernetic	cybernetic
cybernetician	cybernetician
cybernetics	cybernetics
fahrrad	bécane
cyclic	cyclic
cyclical	cyclical
cyclist	cyclist
cyclists	cyclists
cycloid	cycloid
cycloidal	cycloidal
wirbelwind	cyclone
cyclonic	cyclonic
cyclopean	cyclopean
cyclotron	cyclotron
walze	cylindre
väterchen	papa
daddies	daddies
väterchen	papa
dads	dads
verrückt	daffy
verrückt	daft
dolch	dagger
dahlia	dahlia
dahlias	dahlias
täglich	journalier
daintier	daintier
delikat	aimable
milchgeschäft	dairy
dalmatian	dalmate
dalmatians	dalmatians
gehege	dam
beschädigen	endommager
beschädigen	endommager
beschädigen	endommager
beschädigen	endommager
damaged	damaged
damaged	damaged
damager	damager
damagers	damagers
schäden	damages
damaging	damaging
dame	dame
dammit	dammit
damnation	damnation
damned	damned
feucht	damp
dampen	dampen
dampened	dampened
dampness	dampness
dams	dams
ball	bal
der tänzer	dancer
dancers	dancers
dancing	dancing
hundebluhme	pissenlit
dandelions	dandelions
dandies	dandies
dandruff	dandruff
gefahr	danger
besorglich	dangereux
dart	dart
tag	jour
tagesanbruch	point du jour
daylight	daylight
tagen	days
deactivate	deactivate
deactivation	deactivation
sterblich	dead
taub	sourd
deaths	deaths
tief	profond
dichte	density
verdienen	mériter
detat	detat
detre	detre
apparat	appareil
apparat	appareil
dictated	dictated
dictates	dictates
dictation	dictation
dictations	dictations
wörterbücher	dictionaries
wörterbuch	dictionnaire
machte	did
sterben	décéder
died	died
diesel	diesel
diät	diète
dietetically	dietetically
diets	diets
verschieden	différent
schwierigkeiten	difficulties
schwierigkeit	difficulty
ausgraben	creuser
digested	digested
dignitaries	dignitaries
dignities	dignities
würde	dignité
erweitern	dilate
dilated	dilated
doktor	docteur
doeuvre	doeuvre
hund	chien
doggie	doggie
dogs	dogs
saufen	s'enivrer
drinks	drinks
anfeuern	amener à
drizzle	drizzle
trocken	sec
ente	canard
jede	chaque
adler	aigle
eagles	eagles
eaglet	eaglet
ohr	oreille
earache	earache
eardrum	eardrum
eardrums	eardrums
earlobe	earlobe
früh	hâtif
erringen	gagner
earning	earning
earphones	earphones
earring	earring
ohrring	earrings
ohren	ears
boden	butter
erdbeben	earthquake
earthquakes	earthquakes
earths	earths
regenwurm	earthworm
earthworms	earthworms
earwax	earwax
ease	ease
arbeitsbock	établi
easier	easier
leichteste	easiest
easily	facilement
easiness	easiness
orient	est
ostern	pâques
leicht	facile
essen	déjeuner
eatable	eatable
eats	eats
ebony	ebony
eccentric	eccentric
eccentricity	eccentricity
geistlich	ecclesiastic
echo	écho
eclipse	eclipse
ecologic	ecologic
ecologist	ecologist
ecology	ecology
economics	economics
ecru	ecru
acht	huit
achtzehn	dix-huit
eighteenth	eighteenth
eightfold	eightfold
eighth	eighth
eighties	eighties
eightieth	eightieth
achtzig	eighty
eightyfold	eightyfold
einsteinium	einsteinium
jede	either
ausrufen	ejaculate
ejaculated	ejaculated
ejaculates	ejaculates
ejaculating	ejaculating
ejaculation	ejaculation
ejaculations	ejaculations
ejaculatory	ejaculatory
eject	eject
ejectable	ejectable
ejecting	ejecting
ejection	ejection
ejector	ejector
ejectors	ejectors
elaborate	elaborate
elaborated	elaborated
elaborates	elaborates
elaborating	elaborating
ausarbeitung	elaboration
elaborations	elaborations
aufzug	ascenseur
elf	onze
eleventh	eleventh
ausschalten	eliminate
beschließen	cesser
milieu	milieu
bote	envoy
beneiden	envier
beneiden	envier
rolltreppe	escalator
gründen	fonder
begebenheit	événement
etwaig	éventuel
gegebenfalls	eventually
ehemals	jadis
evergreen	evergreen
endlos	infini
jede	every
allenthalben	partout
eviction	eviction
erweis	evidence
ausrufen	exclaim
fabel	fable
fables	fables
gewebe	fabric
fabricant	fabricant
anfertigen	fabriquer
fabricated	fabricated
fabricates	fabricates
fabricating	fabricating
fabrication	fabrication
fabrications	fabrications
fabricator	fabricator
fabricators	fabricators
fabrics	fabrics
fabulist	fabulist
fabulous	fabulous
fassade	façade
facades	facades
faceless	faceless
faceplate	faceplate
facet	facet
scherzhaft	facetious
scherzhaft	facetious
facetiously	facetiously
facial	facial
facies	facies
geläufig	facile
erleichtern	faciliter
facilitated	facilitated
facilitates	facilitates
facilitating	facilitating
möglichkeiten	facilities
hilfsmittel	facility
facing	facing
facsimile	facsimile
tatsache	fact
fraktion	parti
factor	factor
fakultaet	factorial
factorials	factorials
factories	factories
factorization	factorization
factorizations	factorizations
factorize	factorize
factorized	factorized
factors	factors
fabrik	usine
facts	facts
faktisch	factual
facultative	facultative
facultatively	facultatively
faculties	faculties
fakultät	faculté
fad	fad
erblassen	pâlir
faded	faded
fader	fader
faders	faders
fading	fading
faery	faery
faience	faience
unterlassen	fail
flau	faible
faintly	faintly
basar	foire
ziemlich	relativement
fee	fée
gläubig	fidèle
faithfully	faithfully
fashionable	actuel
schnell	jeûner
fastener	fastener
wählerisch	fastidious
dick	épais
fatal	fatal
fatalism	fatalism
fatality	fatality
fatally	fatally
bestimmung	destination
fischen	pêcher
fishable	fishable
fishbowl	fishbowl
fished	fished
fisher	fisher
fisheries	fisheries
fisherman	pêcheur
fishermen	fishermen
fishers	fishers
fishery	fishery
fishes	fishes
angeln	fishing
fishtail	fishtail
fission	fission
fissionable	fissionable
fissure	fissure
faust	poing
fisted	fisted
fistful	fistful
fünf	cinq
fivefold	fivefold
anberaumen	déterminer
fixation	fixation
fixations	fixations
fixity	fixity
fixture	fixture
fixtures	fixtures
fjord	fiord
fjords	fjords
flug	fuite
diskette	floppy
fluently	fluently
fuß	patte
fußball	foot
vergessen	oublier
vergeßlich	forgetful
forgetfulness	forgetfulness
forgivable	forgivable
forgivably	forgivably
entschuldigen	excuser
forgiveness	forgiveness
forgives	forgives
forgiving	forgiving
forgo	forgo
forgoes	forgoes
forgotten	forgotten
forlorn	forlorn
formaldehyde	formaldehyde
vier	quatre
fuchs	renard
fractal	fractal
fractals	fractals
fraktion	fraction
fractionate	fractionate
fraternal	fraternal
fraternize	fraternize
freundin	amie
freundschaft	amitié
fringe	fringe
frosch	grenouille
frogs	frogs
als	de
front	front
fucked	fucked
fudge	fudge
fugue	fugue
fulgurant	fulgurant
angst	peureux
funniest	funniest
drollig	amusant
gab	gab
gabardine	gabardine
gabber	gabber
gabbing	gabbing
gaberdine	gaberdine
hilfsmittel	gadget
freuen	gaiety
frohes	gaily
errungenschaft	acquisition
gained	gained
gaining	gaining
gala	gala
galactic	galactic
galaxy	galaxy
brav	brave
gallantly	gallantly
gallantry	gallantry
galleries	galleries
galerie	galerie
gallon	gallon
galopp	gallop
galloped	galloped
galloping	galloping
galvanic	galvanic
galvanism	galvanism
galvanize	galvanize
galvanized	galvanized
aufführung	jeu
spiels	games
knoblauch	ail
gas	gaz
benzin	essence
ghostwriter	ghostwriter
angebinde	don
gifts	gifts
fahren	aller
ziel	but
ziel	goals
ziege	chèvre
gott	dieu
goddess	goddess
goddesses	goddesses
gevatter	parrain
bucht	golfe
golfer	golfer
golfers	golfers
golfs	golfs
gut	bon
gut	bon
adieu	adieu
goodnight	goodnight
gopher	gopher
kleid	robe
greifen	saisir
gradient	gradient
allmählich	de proche en proche
grammatik	grammaire
traube	raisin
die grapefruit	pamplemousse
habilitated	habilitated
habilitation	habilitation
angewohnheit	coutume
habitant	habitant
habitants	habitants
habitat	habitat
hausen	habitation
habitual	habitual
hatte	had
einhändigen	ouvrier
führen	guider
heats	heats
himmel	ciel
schwer	lourd
hectare	hectare
hectares	hectares
hectoliter	hectoliter
igel	hedgehog
heed	heed
ferse	talon
heeler	heeler
heels	heels
höhe	altitude
hielt	held
helices	helices
dschehenna	hell
hello	hello
lenkrad	gouvernail
helm	helmet
hilfe	aider
hanf	hemp
huhn	poulet
herd	troupeau
hierher	ici
reiher	héron
hips	hips
hauen	battre
hockey	hockey
hogwash	hogwash
holidayer	holidayer
holidays	holidays
nach hause	domicile
homeless	homeless
heim	homes
haus	maison
eis	crème glacée
instancing	instancing
internship	internship
jab	jab
jabber	jabber
jabberwocky	jabberwocky
jabberwocky	jabberwocky
bube	bambin
schakal	jackal
jackals	jackals
jackass	jackass
jackdaw	jackdaw
jacke	veste
jacke	veste
jackknife	jackknife
jackpot	jackpot
strapazieren	jade
abgenutzt	jaded
jag	jag
uneben	jagged
gefängnis	prison
gefängnis	prison
jailbreak	jailbreak
jailed	jailed
jailer	jailer
jailing	jailing
jailor	jailor
jails	jails
jalopy	jalopy
konfitüre	confiture
konfitüre	confiture
jamb	jamb
jammed	jammed
jammed	jammed
jangle	jangle
der hausmeister	janitor
der hausmeister	janitor
jar	jar
jar	jar
jar	jar
jargon	jargon
jasmine	jasmine
jaundice	jaundice
jaunt	jaunt
jaunty	jaunty
javelin	javelin
kiefer	mâchoire
maul	gouffre
eichelhäher	jay
jazz	jazz
jazzy	jazzy
eifersüchtig	jaloux
eifersucht	envie
jeer	jeer
jeer	jeer
gelee	jelly
die qualle	jellyfish
jeopardize	jeopardize
jeopardize	jeopardize
erschüttern	jerk
erschüttern	jerk
deutschem	jerry
jersey	jersey
jersey	jersey
scherzen	plaisanter
hanswurst	jester
hanswurst	jester
jet	jet
jet	jet
jettison	jettison
jetty	jetty
gemme	bijou
jeweler	jeweler
jewelery	jewelery
jewelry	jewelry
jewels	jewels
jib	jib
jib	jib
augenblick	jiffy
jig	jig
jigsaw	jigsaw
jihad	jihad
jilt	jilt
klimpern	tinter
klimpern	tinter
klimpern	tinter
jinx	jinx
nervosität	jitters
arbeit	ouvrage
arbeit	ouvrage
arbeit	ouvrage
arbeitslos	jobless
jockey	jockey
jovial	jocular
jocund	jocund
jodhpur	jodhpur
jog	jog
jogging	jogging
verbinden	adhérer
verbinden	adhérer
joinable	joinable
joined	joined
joiner	joiner
joinery	joinery
fuge	articulation
fuge	articulation
fuge	articulation
gemeinsames	jointly
scherzen	plaisanter
scherzen	plaisanter
joked	joked
joker	joker
jokingly	jokingly
jokingly	jokingly
jolly	jolly
erschüttern	jolt
erschüttern	jolt
jonquils	jonquils
jostle	jostle
jot	jot
jot	jot
journal	journal
journal	journal
journalism	journalism
journalist	journaliste
journalists	journalists
reise	voyage
reise	voyage
gemütlich	jovial
jovially	jovially
freude	joie
joyful	joyful
joyless	joyless
joyously	joyously
jubelfeier	jubilee
richten	juger
richten	juger
judged	judged
urteil	arrêt
judicial	judicial
judiciary	judiciary
judo	judo
kanne	cruche
kanne	cruche
kanne	cruche
juggernaut	juggernaut
gaukeln	jongler
jongleur	juggler
jugular	jugular
saft	jus
juiceless	juiceless
juicier	juicier
juiciest	juiciest
juicy	juicy
jukebox	jukebox
bewegen	jumble
jumbo	jumbo
springen	sauter
jumped	jumped
jumpy	jumpy
union	junction
union	junction
jungle	jungle
junior	junior
juniper	juniper
junk	junk
junk	junk
junk	junk
junk	junk
junkers	junkers
junkers	junkers
junkie	junkie
junkie	junkie
junkyard	junkyard
juridic	juridic
jurisdiction	jurisdiction
jurist	jurist
juror	juror
jurors	jurors
geschworene	jury
billig	juste
gerechtigkeit	justice
justified	justified
justify	justify
justly	justly
jut	jut
juvenile	juvenile
juxtapose	juxtapose
kohl	kale
kaleidescope	kaleidescope
kaleidoscope	kaleidoscope
kängeruh	kangaroo
karat	karat
karate	karate
kayak	kayak
kebab	kebab
kiel	keel
bewahren	continuer
keeps	keeps
andenken	souvenir
keg	keg
keg	keg
kennel	kennel
kennel	kennel
kerchief	kerchief
kern	centre
kern	centre
kern	centre
kerosene	kerosene
ketchup	ketchup
kessel	chaudron
schlüssel/taste	touche
schlüssel/taste	touche
schlüssel/taste	touche
tastatur	keyboard
keyhole	keyhole
keying	keying
keynote	keynote
keypad	keypad
khaki	khaki
stampfen	kick
stampfen	kick
kickback	kickback
kicked	kicked
kicker	kicker
kickoff	kickoff
kicks	kicks
zicklein	kid
zicklein	kid
zicklein	kid
kiddies	kiddies
kiddies	kiddies
kiddies	kiddies
kidnap	kidnap
kidnaped	kidnaped
kidnaper	kidnaper
kidnaper	kidnaper
kidnapers	kidnapers
kidnaping	kidnaping
kidnapped	kidnapped
kidnapper	kidnapper
kidnappers	kidnappers
kidnapping	kidnapping
kidnappings	kidnappings
niere	rein
kidneys	kidneys
kidneys	kidneys
kids	kids
kids	kids
ermorden	rectifier
ermorden	rectifier
killer	killer
killer	killer
killers	killers
killing	killing
killing	killing
killings	killings
killjoy	killjoy
herd	cuisinière
kilogramm	kilogramme
kilogram	kilogram
kilohertz	kilohertz
kiloliter	kiloliter
kilometer	kilomètre
kilowatt	kilowatt
kilt	kilt
verwand	kin
freundlich	affable
freundlich	affable
freundlich	affable
kindergarten	kindergarten
kindergarten	kindergarten
kindergarten	kindergarten
kindergarten	kindergarten
kindhearted	kindhearted
kindhearted	kindhearted
kindheartedness	kindheartedness
zünden	allumer
zünden	allumer
kindlessly	kindlessly
kindlessly	kindlessly
kindliness	kindliness
kindliness	kindliness
kindly	kindly
kindly	kindly
kindly	kindly
kindly	kindly
freundlichkeit	amabilité
freundlichkeit	amabilité
kindred	kindred
kindred	kindred
freundlicher	kinds
freundlicher	kinds
könig	roi
königreich	royaume
königreich	royaume
kingdoms	kingdoms
eisvogel	martin-pêcheur
kingly	kingly
kings	kings
kinky	kinky
kiosk	kiosk
kipper	kipper
küssen	embrasser
küssen	embrasser
küssen	embrasser
küssen	embrasser
kisses	kisses
kisses	kisses
bausatz	kit
bausatz	kit
küche	cuisine
kitchenette	kitchenette
kitchens	kitchens
kitchenware	kitchenware
kitchenware	kitchenware
drachen	kite
kith	kith
kiting	kiting
kätzchen	kitten
kittens	kittens
kitty	kitty
kiwi	kiwi
kiwi	kiwi
kleenex	kleenex
kleenex	kleenex
kleptomania	kleptomania
kleptomaniac	kleptomaniac
knack	knack
knack	knack
tornister	sac tyrolien
kneten	pétrir
kneadable	kneadable
kneader	kneader
knie	genou
kneecap	kneecap
kneel	s'agenouiller
kneel	s'agenouiller
kneeling	kneeling
kneeling	kneeling
kneepad	kneepad
knelt	knelt
knelt	knelt
knickers	knickers
knickknack	knickknack
knickknack	knickknack
messer	couteau
messer	couteau
knifes	knifes
knifing	knifing
kämpe	chevalier
kämpe	chevalier
knighted	knighted
knighthood	knighthood
knightly	knightly
knights	knights
stricken	tricoter
stricken	tricoter
stricken	tricoter
knitted	knitted
knitting	knitting
knitwear	knitwear
knives	knives
gefäß	knob
gefäß	knob
knobby	knobby
knobs	knobs
klopfen	frapper
knockdown	knockdown
knockout	knockout
knoten	nouer
knots	knots
knotted	knotted
knotty	knotty
kennen	connaître
knower	knower
knowhow	knowhow
knowhow	knowhow
weiss	knowing
knowingly	knowingly
knowingly	knowingly
begriff	connaissance
begriff	connaissance
kundig	knowledgeable
known	known
weisst	knows
knuckle	knuckle
knuckle	knuckle
knucklebone	knucklebone
knuckles	knuckles
koala	koala
koala	koala
kosher	kosher
kraut	kraut
kraut	kraut
krauts	krauts
kudzu	kudzu
lab	lab
arbeiten	labor
arbeiter	ouvrier
arbeiter	ouvrier
laborers	laborers
spitze	dentelle
laceration	laceration
lacerations	lacerations
fehlen	défaut
lackadaisical	lackadaisical
bedienter	lackey
lacking	lacking
lackluster	lackluster
laconic	laconic
laconically	laconically
firnissen	lacquer
firnissen	lacquer
junge	lad
damen	ladies
dame	dame
ladybird	ladybird
marienkäfer	ladybug
see	lac
lakes	lakes
lamm	agneau
lambs	lambs
laminated	laminated
laminates	laminates
lampe	lampe
sprache	langue
lachen	rire
ledern	cuir
abreisen	partir
pult	pupitre
vortrag	conférence
lektor	lecturer
regal	ledge
ledger	ledger
lee	lee
bein	jambe
legal	légitime
legality	legality
legalize	legalize
legally	legally
legate	legate
legation	legation
legende	legend
legendary	legendary
legion	legion
epistel	lettre
epistel	lettre
epistel	lettre
achten	comme
hausen	demeurer
gern haben	aimer
gern haben	aimer
freier	amante
glück	destinée
lunch	lunch
mutti	ma
mutti	ma
maam	maam
maam	maam
maam	maam
macabre	macabre
macabre	macabre
macabrely	macabrely
macadam	macadam
macadam	macadam
macadamize	macadamize
macadamize	macadamize
macadamized	macadamized
macadamized	macadamized
macadamizes	macadamizes
macadamizes	macadamizes
macadamizing	macadamizing
macaque	macaque
macaque	macaque
makkaroni	macaroni
macaronies	macaronies
macaroon	macaroon
macaw	macaw
mace	mace
macerate	macerate
macerated	macerated
maceration	maceration
macerations	macerations
maces	maces
machete	machete
machination	machination
machined	machined
machineries	machineries
maschinerie	machinery
machines	machines
machinist	machinist
machinists	machinists
machismo	machismo
macho	macho
macrocephalic	macrocephalic
macrocosm	macrocosm
macroeconomics	macroeconomics
macroevolution	macroevolution
macroevolutionary	macroevolutionary
macroinstruction	macroinstruction
macromolecular	macromolecular
macromolecule	macromolecule
macromolecules	macromolecules
macropathological	macropathological
macropathology	macropathology
macrophage	macrophage
macrophages	macrophages
macrophagic	macrophagic
macroprocessor	macroprocessor
macroscopic	macroscopic
macrosimulation	macrosimulation
macrostructure	macrostructure
maculate	maculate
maculated	maculated
maculates	maculates
maculation	maculation
maculations	maculations
irre	fou
irre	fou
frau	madame
madams	madams
maddened	maddened
made	made
made	made
mademoiselle	mademoiselle
mademoiselles	mademoiselles
meister	maestro
mafioso	mafioso
zeitung	gazette
magie	magie
zauberer	magician
magicians	magicians
magistral	magistral
magistrally	magistrally
magistrature	magistrature
magma	magma
mir	me
mead	mead
anger	prairie
anger	prairie
meadowland	meadowland
meadows	meadows
mager	maigre
meagerly	meagerly
meagre	meagre
mehl	farine
meals	meals
beabsichtigen	moyenne
sich schlängeln	meander
meaningless	meaningless
bedeutung	meanings
bedeutet	instrument
fleisch	viande
meats	meats
meatball	meatball
meatballs	meatballs
mechaniker	mechanical
mechanician	mechanician
mechanism	mechanism
mechanisms	mechanisms
denkmünze	médaille
medallion	medallion
medallions	medallions
mediatrice	mediatrice
mediatrix	mediatrix
medic	medic
medizinisch	medical
medically	medically
medicament	medicament
medicaments	medicaments
medicinal	medicinal
medizin	remède
medicines	medicines
medico	medico
medicolegal	medicolegal
medics	medics
medieval	medieval
medievalist	medievalist
medievalists	medievalists
mediocre	mediocre
mediocrity	mediocrity
erwägen	méditer
meditates	meditates
meditation	meditation
meditations	meditations
meditative	meditative
mittels	medium
medlar	medlar
medley	medley
medleys	medleys
medulla	medulla
medusae	medusae
meek	meek
meekly	meekly
meekness	meekness
meerschaum	meerschaum
megabyte	megabyte
megabytes	megabytes
megacycle	megacycle
megahertz	megahertz
megalith	megalith
megalithic	megalithic
megalomania	megalomania
megalomaniac	megalomaniac
megalomaniacal	megalomaniacal
megaphone	megaphone
melancholia	melancholia
melancholic	melancholic
melange	melange
melodic	melodic
melodies	melodies
melodious	melodious
melodram	melodrama
melodramas	melodramas
melodramatic	melodramatic
melodie	mélodie
melone	melon
melons	melons
melted	melted
anhänger	adhérent
members	members
membrane	membrane
membranes	membranes
membranous	membranous
memoir	memoir
memoirs	memoirs
memorable	memorable
memories	memories
memorize	apprendre par cur
memorized	memorized
männer	men
bevorstehen	gronder
menagerie	menagerie
menageries	menageries
menhir	menhir
meningitis	meningitis
meniscus	meniscus
menopause	menopause
menstrual	menstrual
menstruation	menstruation
menstruations	menstruations
mental	intellectuel
mentality	mentality
menthol	menthol
nennen	mentionner
menü	carte
meow	meow
meowing	meowing
meows	meows
mephitic	mephitic
mercantile	mercantile
mercantilism	mercantilism
mercenaries	mercenaries
mercenary	mercenary
händler	commerçant
merchants	merchants
quecksilber	mercure
barmherzigkeit	compassion
meridian	meridian
meridional	meridional
verdienen	mériter
meritocracy	meritocracy
merits	merits
die meerjungfrau	mermaid
mermaids	mermaids
wohlgemut	gai
auskunft	message
mitteilungen	messages
messiahs	messiahs
messianic	messianic
ächzen	gémir
moaned	moaned
moaning	moaning
moans	moans
moat	moat
moats	moats
mob	mob
äffen	se moquer
mocked	mocked
spott	simulacre
modal	modal
mondschein	moonlight
elch	élan
naiv	naïf
naively	naively
bloß	nu
name	nom
named	named
nameless	nameless
zwar	namely
zwar	namely
names	names
national	national
nationalism	nationalism
nationalist	nationalist
angeboren	inné
natürlich	naturel
naturalize	naturalize
natürlich	bien sûr
neap	neap
beiläufig	près
näher	nearer
unterlassen	dédaigner
nachbar	voisin
neighbors	neighbors
garn	filet
networked	networked
netzwerk	networks
neun	neuf
neunzehn	dix-neuf
nineteenth	nineteenth
nineties	nineties
ninetieth	ninetieth
neunzig	ninety
ninetyfold	ninetyfold
ninth	ninth
niobium	niobium
nip	nip
zitze	mamelon
nipples	nipples
nips	nips
nirvana	nirvana
nitrate	nitrate
nitrated	nitrated
nitrates	nitrates
nitrating	nitrating
nitration	nitration
nitrations	nitrations
nitric	nitric
nitride	nitride
stickstoff	azote
nitroglycerin	nitroglycerin
nitroglycerine	nitroglycerine
edel	élevé
adeliger	noble
noblemen	noblemen
edelmut	grandeur
keine	nul
noctambulism	noctambulism
noctambulist	noctambulist
nocturn	nocturn
nocturnally	nocturnally
nu	eh bien
heutzutage	actuellement
noway	noway
noway	noway
oaf	oaf
oafishness	oafishness
eiche	chêne
ruder	rame
oarsman	oarsman
oase	oasis
hafer	oat
eid	serment
oatmeal	oatmeal
obdurate	obdurate
obedience	obedience
folgsam	docile
obelisk	obelisk
fett	obese
obesity	obesity
ozean	océan
ein	on
apfelsine	orange
oranges	oranges
orbit	orbit
orbital	orbital
orbits	orbits
orchester	orchestre
orchestral	orchestral
orchestras	orchestras
orchestrated	orchestrated
befehlen	commander
ordered	ordered
organismus	organism
organisms	organisms
organist	organist
organists	organists
einrichtung	organization
organizations	organizations
einrichten	organiser
organized	organized
organs	organs
orgasm	orgasm
orgasms	orgasms
orgies	orgies
orgie	orgie
orient	orient
orientable	orientable
orientation	orientation
orientations	orientations
oriented	oriented
orients	orients
orifice	orifice
orifices	orifices
orificial	orificial
ursprung	origine
ursprünglich	inédit
originality	originality
originally	originally
originals	originals
origins	origins
ornamental	ornamental
ornithology	ornithology
orthodox	orthodoxe
orthodoxes	orthodoxes
orthogonal	orthogonal
schreiten	faire les cent pas
schreiten	faire les cent pas
pachyderm	pachyderm
stillen	pacifique
pacifically	pacifically
pacification	pacification
pacifications	pacifications
pacificist	pacificist
pacifier	pacifier
pacifism	pacifism
pazifist	pacifist
pacify	pacify
pacify	pacify
packen	package
packen	package
packaged	packaged
packaged	packaged
packed	packed
bündel	paquet
packing	packing
pact	pact
pacts	pacts
block	bloc
padding	padding
paddeln	barbotter
paddock	paddock
vorhängeschloss	padlock
vorhängeschloss	padlock
padrone	padrone
paella	paella
pagan	pagan
pagans	pagans
pageant	pageant
pageantry	pageantry
paid	paid
eimer	seau
schmerz	douleur
pained	pained
painful	pénible
painful	pénible
painfully	painfully
painstaking	painstaking
färben	couleur
färben	couleur
pinsel	pinceau
maler	peintre
painters	painters
bild	painting
paints	paints
paar	paire
schlafanzug	pajamas
genosse	camarade
genosse	camarade
palast	palais
palatable	palatable
palaver	palaver
blaß	pâle
palette	palette
pall	pall
pallet	pallet
pallette	pallette
pallor	pallor
handfläche	paume
handfläche	paume
palpable	palpable
palpable	palpable
paltry	paltry
broschüre	brochure
pan	pan
panacea	panacea
panama	panama
fladen	pancake
der panda	panda
pandemonium	pandemonium
pane	pane
paneel	lambris
paneling	paneling
panelling	panelling
pang	pang
panik	panique
panik	panique
panicky	panicky
panorama	panorama
stiefmütterchen	pensée
pant	pant
panther	panthère
unterhose	caleçon
speisekammer	buffet
beinkleid	pantalon
papa	papa
dokument	document
broschüre	brochure
parameter	parameter
passer	passer
glut	ardeur
passionately	passionately
passive	passive
passivity	passivity
passwort	password
passwords	passwords
vergangenheit	passé
pasta	pasta
pectorals	pectorals
befremdend	drôle
penitence	penitence
penitences	penitences
penitency	penitency
penitent	penitent
pentadactyl	pentadactyl
pentadactylism	pentadactylism
pi	pi
pianist	pianist
pianistic	pianistic
ansicht	image
pictures	pictures
pastete	pâté
pies	pies
schwein	cochon
abteilung	spécialité
pigment	pigment
pigmentation	pigmentation
pigments	pigments
pigs	pigs
lotsen	pilote
pilots	pilots
pilule	pilule
föhre	pin
ananas	ananas
pineapples	pineapples
pines	pines
rosa	pink
tasche	poche
brieftasche	pocketbook
pocketbooks	pocketbooks
pockets	pockets
podium	estrade
pogrom	pogrom
pogroms	pogroms
zeiger	pointer
pointillism	pointillism
pointillist	pointillist
pointilliste	pointilliste
pointillistic	pointillistic
vergiften	poison
giftig	poisonous
poisonousness	poisonousness
poisons	poisons
polar	polar
polarities	polarities
polarity	polarity
polarize	polarize
polarized	polarized
polemical	polemical
polemically	polemically
polemicize	polemicize
polizei	police
polizist	agent
polizist	agent
polizist	agent
policemen	policemen
policemen	policemen
policemen	policemen
policewoman	policewoman
policewomen	policewomen
polize	politique
polnisch	polonais
polnisch	polonais
artig	courtois
politely	politely
politeness	politesse
politisch	political
politically	politically
politician	politician
politicians	politicians
politik	politique
polka	polka
pollutant	pollutant
pollute	pollute
polluted	polluted
polluter	polluter
pollution	pollution
polonium	polonium
poltergeist	poltergeist
polyandrous	polyandrous
polyandry	polyandry
gießen	verser
schmollen	pout
armut	poverty
pudern	poudre
powdery	powdery
gewalt	puissance
gewältig	puissant
powerless	powerless
powwow	powwow
practicability	practicability
gangbar	practicable
praktisch	réel
beten	prier
gebet	prière
prayers	prayers
praying	praying
praying	praying
predigen	prêcher
predigen	prêcher
preacher	preacher
preacher	preacher
preachers	preachers
preachers	preachers
preaches	preaches
preaches	preaches
preachify	preachify
preaching	preaching
preaching	preaching
preaching	preaching
preachy	preachy
preachy	preachy
preamplifiers	preamplifiers
prearrange	prearrange
prearrange	prearrange
fürst	prince
princedom	princedom
princely	princely
princes	princes
fürstin	princesse
hauptsächlich	principal
hauptsächlich	principal
principalities	principalities
fürstentum	principality
besonders	principalement
besonders	principalement
principals	principals
grundsatz	principe
principles	principles
drucken	impression
drucken	impression
drucken	impression
ausgedruckt	printed
drucker	imprimeur
drucker	imprimeur
priorities	priorities
priorities	priorities
priorität	priority
begründen	démontrer
puls	pouls
pulverizable	pulverizable
pulverizables	pulverizables
pulverization	pulverization
mahlen	moudre
pulverized	pulverized
pulverizer	pulverizer
pulverizers	pulverizers
pulverizes	pulverizes
pulverizing	pulverizing
puma	puma
pumpen	pomper
dringen	pousser
pushchair	pushchair
pushing	pushing
legen	appliquer
putdown	putdown
putout	putout
putrefaction	putrefaction
wachtel	quail
quails	quails
quake	quake
art	propriété
qualm	qualm
qualms	qualms
menge	quantité
disput	se disputer
quarry	quarry
quartier	quartier
quarterdeck	quarterdeck
quarterfinal	quarterfinal
königin	queen
wunderlich	queer
erdrosseln	étouffer
quench	quench
querulous	querulous
anfrage	query
nachsuchung	recherche
frage	question
queue	queue
schikanieren	chicaner
geschwind	prompt
quicklime	quicklime
flugs	rapidement
quicksand	quicksand
quecksilber	quicksilver
fromm	calme
quieten	quieten
quietly	paisiblement
quill	quill
steppen	coudre
quirk	quirk
abdanken	démissioner
sehr	bien
quote	quota
zitat	citation
anführen	citer
r	r
rabbet	rabbet
rabbiner	rabbin
rabbinic	rabbinic
kaninchen	lapin
rabbits	rabbits
gesindel	rabble
rabid	rabid
tollwut	rage
raccoon	raton laveur
abkunft	s'élancer
racehorse	racehorse
racemic	racemic
racer	racer
races	races
rachis	rachis
rachitic	rachitic
rachitis	rachitis
racialism	racialism
racialist	racialist
racialistic	racialistic
racing	racing
racism	racism
racist	racist
arrak	rack
schläger	racket
schläger	racket
radar	radar
radars	radars
radio	radio
lesen	lire
lesbarkeit	readability
readable	readable
reader	lecteur
readers	readers
readership	readership
readership	readership
gern	readily
gern	readily
gern	readily
readiness	readiness
readiness	readiness
lesung	reading
lesung	reading
lesung	reading
readings	readings
readings	readings
readjust	readjust
readjusts	readjusts
readjusts	readjusts
readout	readout
readout	readout
readouts	readouts
reads	reads
bereit	prêt
bereit	prêt
bereit	prêt
reaffirm	reaffirm
reaffirm	reaffirm
reaffirms	reaffirms
reaffirms	reaffirms
reagent	reagent
effektiv	effectif
effektiv	effectif
effektiv	effectif
realisable	realisable
realism	realism
realist	realist
realistic	realistic
realistic	realistic
realistically	realistically
wahrheit	réalité
begreifen	comprendre
tatsächlich	en réalité
reporter	reporter
abbilden	représenter
bitten	demander
bitten	demander
bitten	demander
bahn	chemin
roads	roads
roadwork	roadwork
freibeuter	ravisseur
rotting	rotting
sabbat	sabbat
sabbat	sabbath
sabbatic	sabbatic
sabbatical	sabbatical
saber	saber
sabin	sabin
sable	sable
sabot	sabot
sabotage	sabotage
sabotaged	sabotaged
sabotages	sabotages
saboteur	saboteur
sabra	sabra
sabras	sabras
saccade	saccade
saccharin	saccharin
saccharine	saccharine
saccharose	saccharose
sacerdotal	sacerdotal
sacerdotally	sacerdotally
sachet	sachet
abdanken	licencier
abdanken	licencier
sackcloth	sackcloth
sacked	sacked
sackful	sackful
sacks	sacks
sakrament	sacrament
sacramental	sacramental
sacraments	sacraments
sacre	sacre
heilig	sacré
erbieten	consacrer
sacrificed	sacrificed
sacrifices	sacrifices
sakrilegium	sacrilege
düster	affligé
sadden	sadden
sadder	sadder
saddest	saddest
sattel	selle
saddlebag	saddlebag
saddlebags	saddlebags
saddlebow	saddlebow
saddlecloth	saddlecloth
saddled	saddled
saddleless	saddleless
saddler	saddler
saddlery	saddlery
saddles	saddles
saddletree	saddletree
sadism	sadism
sadist	sadist
sadistic	sadistic
sadistically	sadistically
sadists	sadists
sadly	sadly
betrübnis	affliction
safari	safari
sicher	à l'abri
safecracker	safecracker
safecracking	safecracking
safeguard	safeguard
safeguarded	safeguarded
safeguards	safeguards
safer	safer
safest	safest
sicherheit	sécurité
safflower	safflower
saffron	saffron
sag	sag
saga	saga
einsichtsvoll	intelligent
sagaciously	sagaciously
sagaciousness	sagaciousness
sagacity	sagacity
salbei	sauge
sagely	sagely
sago	sago
saguaro	saguaro
sahib	sahib
sagte	said
segel	voile
segel	voile
sailable	sailable
das segelboat	sailboat
sailboater	sailboater
sailcloth	sailcloth
sailors	sailors
sails	sails
sainfoin	sainfoin
heiliger	saint
sainted	sainted
sainthood	sainthood
saith	saith
sake	sake
salability	salability
salacious	salacious
salat	salade
salads	salads
der salamander	salamander
salaried	salaried
salaries	salaries
absatz	sale
saleable	saleable
saleroom	saleroom
salesclerk	salesclerk
salesgirl	salesgirl
saleslady	saleslady
ladengehilfe	marchand
salesmanship	salesmanship
verkäufer	salesmen
salespeople	salespeople
salesperson	salesperson
salesroom	salesroom
ladenfräulein	saleswoman
saleswomen	saleswomen
salient	salient
saline	saline
salinity	salinity
salinometer	salinometer
salinometers	salinometers
speichel	salive
salivary	salivary
salivate	salivate
salivated	salivated
salivates	salivates
salivating	salivating
salivation	salivation
sallies	sallies
blaß	pâle
sallowish	sallowish
lachs	saumon
salmons	salmons
aula	salon
salons	salons
salzen	saler
saltwater	saltwater
saltworks	saltworks
saltwort	saltwort
salzen	salty
bekömmlich	salubrious
salubrity	salubrity
heil	salut
salver	salver
samba	samba
gleiche	identique
sampan	sampan
samphire	samphire
samurai	samurai
samurais	samurais
sand	sable
sandale	sandale
schule	école
meer	mer
veräußern	vendre
seller	seller
sellers	sellers
serendipity	serendipity
heiter	serein
sieben	36770
sevenfold	sevenfold
siebzehn	dix-sept
seventeenth	seventeenth
seventh	seventh
seventies	seventies
seventieth	seventieth
siebzig	seventy
seventyfold	seventyfold
sever	sever
streng	sévère
severed	severed
severely	severely
severities	severities
severity	severity
sewage	sewage
geschlecht	sexe
sexagenarian	sexagenarian
generisch	sexual
sexually	sexually
shades	shades
schatten	ombre
shadows	shadows
shagreen	shagreen
schah	schah
erschüttern	secouer
shakedown	shakedown
shaken	shaken
shaky	shaky
shaman	shaman
shamanism	shamanism
shampoo	shampoo
shampoos	shampoos
hammel	mouton
sheepherder	sheepherder
abfertigen	expédier
abfertigen	expédier
mist	shit
krank	malade
silber	argent
singen	chanter
berufssänger	chanteuse
tauchen	forer
sechs	six
sechzehn	seize
sixteenth	sixteenth
sixties	sixties
sechzig	soixante
sixtyfold	sixtyfold
ausdehnung	ampleur
rochen	patin
skateboard	skateboard
skateboarder	skateboarder
skateboarding	skateboarding
skateboards	skateboards
skater	skater
skaters	skaters
skates	skates
skating	skating
geschicklichkeit	adresse
geübt	skilled
skilless	skilless
geübt	adroit
himmel	ciel
lerche	skylark
skyscraper	skyscraper
snout	snout
schneien	neiger
snowball	snowball
schneeflocke	flocon de neige
snowman	snowman
snowstorm	snowstorm
software	software
sorrily	sorrily
betrübnis	sorrow
abart	sorte
sorted	sorted
sorter	sorter
gemüt	âme
spectra	spectra
spectrum	spectrum
speculate	speculate
speculation	speculation
klammer	parenthèse
stapled	stapled
die heftmaschine	stapler
staplers	staplers
staples	staples
stern	étoile
stars	stars
anstellen	activer
stifled	stifled
stärke	force
blödsinnig	sot
subjekt	sujet
erfolg haben	arriver
erfolg	prospérité
sonne	soleil
sunbathe	sunbathe
sonnig	sunny
suppressed	suppressed
argwöhnen	soupçonner
lästern	blasphémer
tab	tab
tab	tab
tabernacle	tabernacle
tabelle	liste
tableau	tableau
tableaus	tableaus
tableaux	tableaux
tischtucher	tablecloth
tablecloths	tablecloths
tables	tables
tabelle	liste
tablets	tablets
taboos	taboos
tachometer	tachometer
tachometers	tachometers
tacit	tacit
sterz	queue
schneidern	couturière
tailored	tailored
tailors	tailors
frack	habit
arbeit	devoir
angaben	tasks
schmecken	goût
tasted	tasted
fade	tasteless
zerreißen	larme
zerreißen	larme
zerreißen	larme
zerreißen	larme
teardrop	teardrop
tearful	tearful
tearfully	tearfully
tearfully	tearfully
teargas	teargas
tearjerker	tearjerker
tearless	tearless
tearless	tearless
tearoom	tearoom
tränen	tears
tränen	tears
tearstained	tearstained
tearstained	tearstained
tease	agacer
tease	agacer
tease	agacer
teasel	teasel
teaser	teaser
teaser	teaser
teases	teases
teases	teases
teases	teases
teasing	teasing
teasing	teasing
teasingly	teasingly
teasingly	teasingly
teaspoon	teaspoon
teaspoon	teaspoon
teaspoonful	teaspoonful
brust	mamelle
brust	mamelle
brust	mamelle
brust	mamelle
teatime	teatime
teats	teats
teats	teats
zehn	dix
tendencies	tendencies
stimmung	aptitude
tenderfoot	tenderfoot
zärtlich	tenderly
daher	thence
daher	thence
thenceforth	thenceforth
thenceforward	thenceforward
theocracy	theocracy
theocratic	theocratic
theodolite	theodolite
theologe	theologian
theologians	theologians
theological	theological
theologically	theologically
theologie	theology
theorem	theorem
theorems	theorems
theoretical	theoretical
theoretical	theoretical
theoretically	theoretically
theoretician	theoretician
theoretician	theoretician
theoreticians	theoreticians
theoreticians	theoreticians
theorist	theorist
theorist	theorist
theorists	theorists
theorists	theorists
theorize	theorize
dieb	thief
obgleich	quoique
obgleich	quoique
gedanke	pensée
gedanke	pensée
thoughtful	thoughtful
thoughtfully	thoughtfully
vorsorge	précaution
thoughtless	thoughtless
thoughtlessly	thoughtlessly
thoughtlessness	thoughtlessness
tausend	mille
thousandth	thousandth
verhauen	thrash
verhauen	thrash
faden	fil
faden	fil
faden	fil
threadbare	threadbare
bedrohung	menace
bevorstehen	gronder
threatening	sinistre
threateningly	threateningly
drei	trois
tigress	tigress
heute	aujourd'hui
zehe	doigt du pied
tradition	tradition
traditionell	traditional
geleise	trail
abrichten	clique
trainee	trainee
trainer	trainer
traitor	traitor
transaction	transaction
transalpine	transalpine
transcribe	transcribe
entern	passer
übersetzen	traduire
übersetzung	translation
übersetzer	translator
schicken	adresser
baum	arbre
lastauto	camiono
zwei	deux
ubiquitous	ubiquitous
ubiquity	ubiquity
euter	pis
ugh	ugh
uglier	uglier
ugliest	ugliest
uglify	uglify
uglily	uglily
ugliness	ugliness
häßlich	laid
ukulele	ukulele
geschwür	ulcère
ulcerate	ulcerate
ulcerated	ulcerated
ulceration	ulceration
ulcerative	ulcerative
ulna	ulna
ultimo	ultimo
arbeitlosigkeit	unemployment
vacant	vacant
vacate	vacate
ferien	vacances
impfen	vacciner
vaccinated	vaccinated
vacuum	vacuum
vacuumed	vacuumed
vagina	vagin
vagrant	vagrant
vague	vague
vergebens	vain
wacky	wacky
wag	wag
walnuß	noix
geschäft	warehouse
geschäft	warehouse
warehouses	warehouses
spülen	laver
tränen	pleurer
weeping	weeping
weeping	weeping
weeps	weeps
weepy	weepy
weepy	weepy
weevil	weevil
weft	weft
wägen	peser
wägen	peser
weighing	weighing
weighings	weighings
weighs	weighs
gewicht	poids
weighted	weighted
weighted	weighted
weightily	weightily
weighting	weighting
weighting	weighting
weightless	weightless
gewichtslosigkeit	weightlessness
weights	weights
weights	weights
schwer	weighty
schwer	weighty
weir	weir
seltsam	bizarre
weirdie	weirdie
weirdies	weirdies
weirdly	weirdly
weirdness	weirdness
weirdness	weirdness
weirdo	weirdo
weirdos	weirdos
weirs	weirs
willkommen	recevoir solennellement
willkommen	recevoir solennellement
willkommen	recevoir solennellement
willkommen	recevoir solennellement
war	où
fenster	fenêtre
fenster	fenêtre
windowpane	windowpane
windowpanes	windowpanes
windows	windows
windstorm	windstorm
wein	vin
wineglass	wineglass
winegrower	winegrower
winemaker	winemaker
winemaking	winemaking
winepress	winepress
wines	wines
winey	winey
fittich	aile
winglet	winglet
zwinkern	wink
winter	hiver
wischen	effacer
draht	fil
draht	fil
draht	fil
wired	wired
radio	radio
wiring	wiring
wiry	wiry
weisheit	intelligence
gescheit	raisonnable
wisecrack	wisecrack
wisely	wisely
wiser	wiser
wünschen	désirer
wünschen	désirer
wishbone	wishbone
wünsche	wishes
wishful	wishful
hexe	witch
witches	witches
mit	à
zurückziehen	décéder
zurückziehen	décéder
ohne	sans
zeuge	témoin
zeuge	témoin
witnesses	witnesses
wolverine	wolverine
wolverine	wolverine
welt	monde
universal	worldwide
xenophobe	xenophobe
xenophobia	xenophobia
xenophobic	xenophobic
xerographic	xerographic
xylem	xylem
xylene	xylene
xylophone	xylophone
xylophones	xylophones
xylophonist	xylophonist
xylose	xylose
xylotomic	xylotomic
jacht	yacht
yachting	yachting
yachtsman	yachtsman
yak	yak
yamswurzel	igname
yap	yap
hof	cour
yardstick	yardstick
yarn	yarn
gähnen	bâiller
gähnen	bâiller
yawning	yawning
ja	yeah
jahr	an
yearbook	yearbook
yearlong	yearlong
jährlich	annuellement
jährlich	annuellement
sich ersehnen	aspirer
yearning	yearning
yearningly	yearningly
jahr	years
yeast	yeast
heulen	yell
heulen	yell
gelb	jaune
yellowed	yellowed
yellowing	yellowing
yellowish	yellowish
ja	bien
gestern	hier
noch	encore
yew	yew
abtreten	abandonner
yoga	yoga
yoghurt	yaourt
yogurt	yogurt
joch	yoke
yolk	yolk
du/sie	te
du/sie	te
jung	jeune
jüngere	younger
jüngling	youngster
jugend	youth
youthful	youthful
yuppie	yuppie
zabaglione	zabaglione
zany	zany
zazen	zazen
eifer	ferveur
eifrig	fervent
zebra	zèbre
zenit	zenith
null	zero
null	zero
zest	vigueur
im zickzack gehen	zigzag
zink	zinc
reissverschluss	fermeture éclair
tierkreis	zodiac
tierkreis	zodiac
zone	zone
zone	zone
zoo	zoo
zoologie	zoology
zoom	zoom
zucchini	zucchini
