ein	en/ett
ein	en/ett
aardvark	jordsvin
aardvark	jordsvin
aardvarks	aardvarks
zurück	bakåt
zurück	bakåt
zurück	bakåt
abacterial	abacterial
abacus	kulram
abacus	kulram
abacus	kulram
abacuses	abacuses
abacuses	abacuses
abacuses	abacuses
abaft	akter ut
abalone	abalone
abalones	abalones
ablassen	överge
ablassen	överge
impertinent	övergiven/övergivna
impertinent	övergiven/övergivna
impertinent	övergiven/övergivna
abandonee	abandonee
abandoner	abandoner
abandoning	abandoning
zession	uppgivenhet
zession	uppgivenhet
abandonments	abandonments
demütigen	förnedra
abased	abased
abasement	förnedring
abasements	abasements
abases	abases
beschämen	göra generad
verlegen	generad
verlegen	generad
abasing	abasing
erschlaffen	minska/lindra
erschlaffen	minska/lindra
abated	abated
nachlaß	avtagande
nachlaß	avtagande
abatements	abatements
abates	abates
abating	abating
abating	abating
abattoir	slakthus
abbe	abbe
abberations	abberations
abtei	kloster
abtei	kloster
abbeys	abbeys
abt	abbot
abt	abbot
abt	abbot
abt	abbot
abt	abbot
abbots	abbotar
abkürzen	förkorta
abkürzen	förkorta
abbreviated	abbreviated
abbreviates	abbreviates
abbreviating	abbreviating
verkürzung	förkortning
verkürzung	förkortning
verkürzung	förkortning
verkürzungen	förkortningar
verkürzungen	förkortningar
abbreviator	abbreviator
abdicable	abdicable
abdanken	avsäga sig
abdanken	avsäga sig
abdicated	abdicated
abdication	avsägelse
abdicator	abdicator
hinterleib	kropp
hinterleib	kropp
abdomens	abdomens
den unterbauch betreffend	buk-
abdominally	abdominally
abduct	bortföra
abducted	abducted
abducting	abducting
abduction	bortrövande
abductions	abductions
abductor	kidnappare
abductors	abductors
quer	tvärs
abecedarian	alfabetisk
abed	till sängs
abweichung	avvikelse
aberrant	som far vilse
aberrantly	aberrantly
aberration	villfarelse
aberration	villfarelse
aberrations	aberrations
agitieren	underblåsa
mithilfe	medhjälp
abets	abets
abetted	abetted
abetter	abetter
abetting	abetting
abettor	medhjälpare
ruhen	vila
abeyant	abeyant
verabscheuen	avsky
abhorred	abhorred
abscheu	avsky
abhorrent	motbjudande
abhorrently	abhorrently
abhorring	abhorring
abhors	abhors
gewärtigen	stanna/vänta
abided	abided
abides	abides
fest	bestående/varaktig
abilities	själsgåvor
kapazität	möjlighet
kapazität	möjlighet
abiotic	abiotic
gemein	föraktlig
abjection	uselhet
abjectly	abjectly
abjuration	avsvärjande
annullieren	avsvärja
abjurer	abjurer
ablation	borttagande
ablativ	ablativ
ablaze	i lågor
ablaze	i lågor
begabt	kunna
begabt	kunna
begabt	kunna
begabt	kunna
abler	abler
ablest	ablest
abloom	i blom
ablution	tvätta sig
ablutions	tvagning
ably	skicklig/duktigt/kunnigt
abnegate	avsäga sig
abnegates	abnegates
aufopferung	förnekelse
abnormal	avvikande
abnormal	avvikande
abnormal	avvikande
abnormalities	abnormalities
abnormalität	abnormitet
abnormally	onormalt
an bord	ombord
wohnort	boning/vistelse
abodes	abodes
aboil	kokande
annullieren	avskaffa
annullieren	avskaffa
abolishable	abolishable
abolished	avskaffade
abolisher	abolisher
abolishes	abolishes
abolishment	abolishment
abolition	avskaffande
abolition	avskaffande
abolitionism	abolitionism
abolitionist	förkämpe
abolitionists	abolitionists
abscheulich	avskyvärd
abominably	abominably
verabscheuen	avsky
abscheu	avsky
abominations	abominations
eingeboren	urinvånare
aboriginally	aboriginally
aborigine	urinvånare
aborigines	aborigines
abortieren	abort
aborted	avbrutits
aborter	aborter
aborting	aborting
fiasko	missfall/abort
fiasko	missfall/abort
abortionist	abortör
abortionists	abortionists
abortions	abortions
nutzlos	misslyckad
abortively	abortively
aborts	aborts
schwärmen	överflöda av
betreffs	om/cirka
oberhalb	ovan
aboveboard	aboveboard
aboveground	aboveground
abovementioned	abovementioned
abovementioned	abovementioned
abracadabra	abrakadabra
abradable	abradable
hobeln	skava av
abrasion	avskavning/slitning
abrasions	abrasions
grell	sträv
abrasives	abrasives
abreast	jämsides
begrenzen	förkorta
abridged	abridged
übersicht	förkortning/sammandrag
abridging	abridging
äußerlich	utomlands
annullieren	avskaffa
abrogated	abrogated
abrogation	abrogation
abgerissen	hastig
abruptly	abrupt
abruptness	abruptness
abszeß	böld
abscesses	abscesses
ausreißen	rymma
absconded	absconded
abwesenheit	frånvaro
absences	absences
abwesend	frånvarande
abwesend	frånvarande
absenteeism	skolk
absentees	absentees
abwesend	frånvarande
absentminded	absentminded
absentmindedly	absentmindedly
absentmindedly	absentmindedly
absentmindedness	absentmindedness
beifuß	absinth
beifuß	absinthe
absolut	absolut
freilich	absolut
begnadigung	frikännande
absolutismus	envälde
absolvieren	frikänna
absolved	absolved
absolving	absolving
absorbieren	uppta
absorbability	absorbability
absorbable	absorbable
absorbant	absorbant
absorbed	ingick i
absorbent	absorberande
absorbing	absorberande
absorption	absorbering
abstain	avstå
abstained	abstained
abstinent	återhållsam
abstinenz	röstnedläggelse
abstentions	abstentions
abstinenz	röstnedläggelse/återhållsamhet
abstinent	måttlig
abstinently	abstinently
abstrakt	abstrakt
abstrakt	abstrakt
diebstahl	abstraktion
geheimnissvoll	dunkel
abgeschmackt	orimlig
absurdism	absurdism
absurdist	absurdist
absurdities	absurdities
verdrehtheit	orimlighet
reichtum	överflöd
reichlich	överflödande
im überfluß	abundantly
beleidigen	missbruk
abused	missbrukat
anzüglich	ovettig/smädlig
abusively	abusively
abut	gränsa intill
abuzz	abuzz
unerforschlich	bottenlös
abysmally	abysmally
abgrund	avgrund
abgrund	avgrund
abysses	abysses
abysses	abysses
akazie	akacia
student	akademisk
academical	akademisk
academically	akademiskt
academician	akademimedlem
academies	academies
academism	academism
akademie	akademi
akanthus	acanthus
acanthuses	acanthuses
beipflichten	tillträda/biträda
beipflichten	tillträda/biträda
beeilen	accelerera
accelerated	accelererade
acceleration	acceleration
accelerations	accelerations
accelerator	gaspedal
accelerators	accelerators
accelerometer	accelerometer
accelerometers	accelerometers
accent	tonvikt
betonte	betonade
betonte	betonade
accents	accents
accentual	accentual
accentually	accentually
betonen	betona
accentuated	accentuated
accentuation	betoning
annehmen	acceptera
acceptability	godtagbarhet
acceptable	godtagbart
acceptably	acceptabelt
annahme	accepterande
accepted	accepterad
accepter	accepter
acceptor	acceptant
anfall	tillgång
accessed	åtkomliga
accessibility	accessibility
zugänglich	åtkomlig
errungenschaft	tillträde/tillskott
accessorial	accessorial
zubehör	tillbehör
accessorize	accessorize
accessors	accessors
accessory	tillbehör
unfall	olycka
zufällig	tillfällig
accidentalism	accidentalism
accidentalist	accidentalist
accidentally	händelsevis
accidently	accidently
accidents	olyckor
akklamieren	hylla/hälsa såsom
beifall	bifallsrop
acclimate	acclimate
acclimated	acclimated
akklimatisieren	anpassa
accolade	dubbning till riddare
accolades	accolades
adaptieren	anpassa
accommodated	anpassad
entgegenkommend	tillmötesgående
einrichtung	anpassning
accommodations	accommodations
accompanied	accompanied
accompanier	accompanier
accompanies	accompanies
geleit	ackompanjemang
accompaniments	accompaniments
gefährte	ackompanjatör
accompanists	accompanists
begleiten	ackompanjera
accompanyist	accompanyist
accompanyists	accompanyists
accomplice	medbrottsling
accomplices	accomplices
erlangen	utföra
accomplished	presterade
accomplishment	prestation
accomplishments	accomplishments
akkord	bevilja/medge
accordance	enlighet
accorder	accorder
accorders	accorders
ziehharmonika	dragspel
accordionist	accordionist
accordionists	accordionists
accordions	accordions
accords	accords
ansprechen	tilltala
konto	beräkning
accountability	ansvarighet
accountable	ansvarig/förklarlig
buchrevisor	bokförare
buchführung	bokföring
accouterment	accouterment
accrued	accrued
accruement	accruement
accumulated	samlat
acetaminophen	acetaminophen
acetify	acetify
acetone	aceton
herb	sur
acidic	acidic
allergen	allergen
allergen	allergen
allergic	allergisk
allergies	allergier
allergies	allergier
allergie	allergi
allergie	allergi
alleviate	mildra
alleviated	lätta
gasse	gränd
gasse	gränd
alleys	alleys
alleys	alleys
verbindlichkeit	förbindelse
verbindlichkeit	förbindelse
alliances	alliances
alliances	alliances
allied	allierad
allied	allierad
alligator	alligator
alligator	alligator
alligators	alligators
alligators	alligators
alliteration	alliteration
alliteration	alliteration
alliterations	alliterations
alliterations	alliterations
allocate	tilldela
allocated	tilldelat
allocation	tilldelning
allocation	tilldelning
allocations	tilldelningen
allocution	allocution
allocution	allocution
allocution	allocution
verlosen	fördela
lassen	tillåta
zulässig	tillåtna
erlaubnis	tillstånd
erlaubt	tillåten
legierung	legering
alphabet	alfabete
alphabetic	alfabetisk
alphabetical	alfabetisk
alphabetization	alphabetization
alphabetizations	alphabetizations
alphabetize	alphabetize
alphabetized	alphabetized
alphabetizing	alphabetizing
alphabets	alfabeten
alphamerical	alphamerical
alphanumerisch	alfanumerisk
alphanumerical	alphanumerical
alphanumerically	alphanumerically
alphanumerics	alphanumerics
alpine	alpin
alpinism	alpinism
alpinist	alpinist
bereits	redan
auch	även
altercation	gräl
altercations	altercations
sich ablösen	växla
alternated	alternated
alternately	alternativt
unter	bland
amoral	amoralisk
amorous	kärleksfull
amorously	amorously
amorph	formlös
anzahl	summa
anzahl	summa
amp	ampere
ampère	ampere
ampersand	ampersand
amphetamine	amfetamin
und	och
anyway	hursomhelst
irgendwo	varsomhelst
aorta	aorta
schnell	snabbt
abgesondert	isär
apartheid	apartheid
appartement	lägenhet
indolent	apatisk
apathie	apati
affe	människoapa
affe	människoapa
aperitif	aperitif
öffnung	öppning
spitze	spets
aphid	aphid
eintreffen	anländer
espe	aspen
kontrollieren	granska/revidera
auditorium	mötessal
auditoriums	auditoriums
audits	audits
verfügbar	tillgänglig
quasseln	pladdra/sorl
babbler	pratmakare
babies	babies
pavian	babian
kinder	barn
baccalaureate	kandidatexamen
baccarat	baccarat
hagestolz	ungkarl
bachelors	ungkarlar
bacilli	bacilli
bacillus	bacill
rücken	tillbaka
backache	ryggsmärtor
backbite	baktala
wirbelsäule	ryggrad
hintergrund	bakgrund
backgrounds	backgrounds
after	bak
backslide	återfalla
backup	ta kopia
backward	bakåt
speck	sidfläsk
bakterien	bakterie
böse	dålig
insignien	emblem
badged	badged
badgers	badgers
badinage	raljeri
beutel	väska
lapalie	bagatell
bagatelles	bagatelles
bagage	bagage
bags	påsar
baguette	list
bah	bah
bail	borgen
köder	agn
backen	baka
bäcker	bagare
bakeries	bakeries
bakers	bakers
bäckerei	bageri
bakeshop	bakeshop
saldo	balans
balconies	balconies
altan	balkong
kahlköpfig	skallig/kal
baldhead	baldhead
baldly	rakt på sak
baldness	skallighet
bale	bal/packe
baleen	valfiskben
hindern	hindra
ball	boll/kula
ballade	visa
ballade	ballad
ballads	ballader
ballast	barlast
ballett	balett
balletic	balletic
ärostat	ballong
ballot	valsedel/sluten omröstning
balls	ballar/bollar
ballyhoo	ballyhoo
balsam	balsam
bambus	bambu
betrügen	lura
banane	banan
bananas	bananas
bande	musikkår
bandage	bandage
bandeau	hårband
bandit	bandit
bandits	bandits
bandleader	bandleader
bandmaster	kapellmästare
bane	fördärv
banished	fördriven
barb	hulling
barbar	barbar
barbarians	barbarer
barbarismus	barbarismen
barbier	frisör
barmaid	barflicka
barman	bartender
kaserne	kaserner
strand	stranden
aushalten	bära
aushalten	bära
beet	säng
schlafzimmer	sovrum
glauben	tro
verraten	förråda
bibliographic	bibliographic
bibliographies	bibliografier
bibliographie	källförteckning
brombeere	björnbär
buch	bok
boomerang	boomerang
boxer	boxer
junge	pojke
boys	pojkar
gehirn	hjärna
brood	kull/yngel/ruva/grubbla
besen	kvast/ginst
broth	buljong/köttsoppa
bauen	bygga
anbau	byggnad
adieu	hejdå
droschke	droska/förarhytt
cabal	kabal
cabala	cabala
cabalism	cabalism
cabalist	cabalist
cabalistic	cabalistic
caballero	caballero
cabaret	krog
kohl	kål
cabbages	cabbages
cabdriver	cabdriver
hütte	hytt
kabinett	skåp/kabinett
cabinetmaker	cabinetmaker
cabinetmakers	cabinetmakers
cabinets	cabinets
cabins	hytter
kabel	kabel
cabled	cabled
cablegram	cablegram
cablegrams	cablegrams
cables	kablar
cabling	cabling
chauffeur	chaufför
caboose	kabyss
cabotage	kustfart
cabriolet	cabriolet
cabs	cabs
cacao	kakao
cacciatore	cacciatore
cachalot	kaskelot
cache	gömställe
cachepot	cachepot
caches	caches
cackle	kackel/kackla/prat/fnitter
cackled	cackled
cackles	cackles
cackling	cackling
cacophony	missljud
cacti	cacti
kaktus	kaktus
cad	lymmel
kadaver	cadaver
cadaverous	cadaverous
caddies	caddies
caddy	teburk
cadence	cadence
cadet	yngre son/kadett
cadetship	cadetship
cadge	cadge
cadger	cadger
cafe	cafe
cafes	cafes
cafeteria	cafeteria
cafeterias	cafeterias
caffeine	caffeine
kaftan	caftan
bauer	bur
cages	burar
cahier	cahier
cairn	röse
cairns	cairns
caitiff	caitiff
cajole	smickra
cajoler	cajoler
cajolery	mild övertalning
kuchen	tårta/bakelse/kaka
kuchen	tårta/bakelse/kaka
kalcium	kalcium
erachten	beräkna
calculated	beräknad
calibrieren	kalibrera
calibrated	calibrated
calibration	calibration
auto	bil
carbonization	carbonization
carbonize	carbonize
carbonized	carbonized
carbonless	carbonless
carburetor	carburetor
carburetors	carburetors
carburization	carburization
carburize	carburize
karte	kort
cardamom	cardamom
cardiac	cardiac
cardigan	kofta/stickad ylleväst
cardioid	cardioid
cardioids	cardioids
sorge tragen	varsamhet
sorge tragen	varsamhet
cared	cared
karriere	karriär
bedächtig	försiktig
sorgfältig	noggrannt
katze	katt
karzer	cell
cellular	cellular
zufällig	chans
die kirschen	cherries
kirche	kyrkan
churches	kyrkorna
mantel	kappa
cloaks	cloaks
uhr	klocka
clockmaker	clockmaker
clockwise	medsols
cloister	pelargång/kloster
clone	klon
wolke	moln
clouds	clouds
kohle	kol
computer	dator
computers	datorer
comrades	kamrater
concealed	hemliga
conjuring	conjuring
contemplate	begrunda/ha för avsikt
contemplate	begrunda/ha för avsikt
contemplate	begrunda/ha för avsikt
contemplates	contemplates
contemplation	contemplation
contemplation	contemplation
contemplation	contemplation
contemplations	contemplations
contemplations	contemplations
contemplative	contemplative
contemporaneous	contemporaneous
contemporaneously	contemporaneously
contemporaries	contemporaries
contemporaries	contemporaries
zeitgenössisch	samtidig/samtida/jämnårig
zeitgenössisch	samtidig/samtida/jämnårig
verachtung	förakt
verachtung	förakt
contemptible	contemptible
contemptibly	contemptibly
contemptuous	föraktfull/hånfull
contemptuous	föraktfull/hånfull
contemptuously	contemptuously
contemptuously	contemptuously
contend	strida/tävla/påstå
contend	strida/tävla/påstå
contend	strida/tävla/påstå
contender	contender
contender	contender
contender	contender
contenders	contenders
contenders	contenders
contenders	contenders
contending	contending
contending	contending
contends	contends
contends	contends
inhalt	innehåll
inhalt	innehåll
inhalt	innehåll
zufrieden	tillfredsställd
zufrieden	tillfredsställd
contentedly	contentedly
contentedness	contentedness
contention	contention
contention	contention
contention	contention
contentions	contentions
contentions	contentions
contentions	contentions
contentious	contentious
contentious	contentious
contentment	belåtenhet
inhalt	innehåll
inhalt	innehåll
konkurrenz-prüfung	strid/bestrida/tävlan
konkurrenz-prüfung	strid/bestrida/tävlan
konkurrenz-prüfung	strid/bestrida/tävlan
contestant	contestant
contestant	contestant
kinderbett	babysång/vagga/barnsäng
coterie	coterie
cotillion	cotillion
cotillon	cotillon
häuschen	villa/stuga
cottager	cottager
couch	soffa
husten	hosta
coughs	coughs
rechne	räkna
angesicht	ansikte
counteract	motverka
counterbalance	counterbalance
countermand	countermand
countermarch	countermarch
counterplot	counterplot
counterpoint	kontrapunkt
counterpoise	counterpoise
counterweight	counterweight
countess	grevinna
zahllos	oräkneliga
gefilde	land
countryman	landsman/lantman
countrywide	countrywide
county	grevskap/län
ehepaar	par
couplet	verspar
coupon	kupong
mut	mod
beherzt	modig
courageously	courageously
courier	kurir/löpare
kurs	kurs/bana
courser	springare/harjägare
den hof machen	domstol
artig	hövlig
courteously	courteously
courteousness	courteousness
courtesy	artighet
courthouse	courthouse
courtier	hovman
courtliness	courtliness
courtly	elegant/artig
courtmartial	courtmartial
gericht	courtroom
courtship	courtship
base	kusin
cove	bukt
vereinbarungen	avtal/förbund
einband	täcka
covert	hemlig/gömställe
gelüsten	eftertrakta
covetous	covetous
covetously	covetously
kuh	ko
kuh	ko
coward	feg/stackare
cowardice	feghet
cowardly	cowardly
kauern	krypa ihop
cowherd	cowherd
kappe	huva/rökhuv
coxcomb	sprätt
coy	blyg/pryd
coyly	coyly
coyness	coyness
coyote	prärievarg
cozily	cozily
cozy	cozy
crabapple	crabapple
crabbed	crabbed
spalte	spricka upp
cracker	smällkaramell/knäckare
knistern	spraka
wiege	vagga
craft	hantverk/fartyg/flygplan
craftily	craftily
crag	brant klippa/klippspets
cram	stoppa/packa
cramp	kramp/hindra
cranberry	tranbär
kranich	trana/lyftkran
cranium	cranium
crankiness	crankiness
cranky	cranky
crape	crape
crash	krascha
crate	packkorg/spjällåda
crater	crater
crave	be om/längta efter
feig	feg
kriechen	kravla
krebs	kräfta
buntstift	färgkrita
wut	mani
crazily	crazily
irre	tokiga
fletschen	knarra
rahm	grädde
creamy	creamy
zerknittern	veck/rynka
schaffen	skapa
creation	skapelse
creator	skapare
gebilde	varelse
credence	tilltro
credential	credential
kredit	kredit
creditable	creditable
creditably	creditably
gläubiger	borgenär/fordringsägare
credo	credo
credulity	credulity
leichtgläubig	godtrogen
credulously	credulously
creed	trosbekännelse
creek	liten vik/bukt
kriechen	krypa/smyga
creeps	kryper
brennen	bränna
mähen	klipp
süss	söt
süss	söt
cuteness	cuteness
cutoffs	cutoffs
cutout	cutout
schneidet	klipper
cutter	kniv/tillskärare
cutting	sågning
cyanate	cyanate
cyanide	cyanid
cybernetic	cybernetic
cybernetician	cybernetician
cybernetics	cybernetics
fahrrad	cykel
cyclic	cyclic
cyclical	konjunkturbetingad
cyclist	cyclist
cyclists	cyklister
cycloid	cycloid
cycloidal	cycloidal
wirbelwind	cyclone
cyclonic	cyclonic
cyclopean	cyclopean
cyclotron	cyclotron
walze	cylinder
väterchen	pappa
daddies	daddies
väterchen	pappa
dads	dads
verrückt	tokig
verrückt	tokig
dolch	dolk
dahlia	dahlia
dahlias	dahlias
täglich	daglig
daintier	daintier
delikat	utsökt/fin
milchgeschäft	mejeri/mjölkbutik
dalmatian	dalmatisk
dalmatians	dalmatians
gehege	damm/dämma upp/djurmoder
beschädigen	skada
beschädigen	skada
beschädigen	skada
beschädigen	skada
damaged	skadade
damaged	skadade
damager	damager
damagers	damagers
schäden	skador
damaging	damaging
dame	dame
dammit	dammit
damnation	fördömelse
damned	förbaskade
feucht	fuktig
dampen	bli fuktig
dampened	dampened
dampness	dampness
dams	dams
ball	dansa
der tänzer	dansör/dansös
dancers	dansare
dancing	dansande
hundebluhme	maskros
dandelions	dandelions
dandies	dandies
dandruff	mjäll
gefahr	fara
besorglich	farliga
dart	pil/rusa
tag	dag
tagesanbruch	gryning
daylight	dagsljus
tagen	dagar
deactivate	avaktivera
deactivation	deactivation
sterblich	död
taub	döv
deaths	dödens
tief	djup
dichte	densitet
verdienen	förtjäna
detat	detat
detre	detre
apparat	tillbehör
apparat	tillbehör
dictated	dictated
dictates	dikterar
dictation	diktamen/diktat/maktbud
dictations	dictations
wörterbücher	ordböcker
wörterbuch	lexikon
machte	gjorde
sterben	dö
died	dött
diesel	disel
diät	kost
dietetically	dietetically
diets	diets
verschieden	annorlunda/olika
schwierigkeiten	svårigheter
schwierigkeit	svårighet
ausgraben	gräva/grävde/grävt
digested	digested
dignitaries	dignitaries
dignities	dignities
würde	värdighet
erweitern	utvidga
dilated	dilated
doktor	doktor
doeuvre	doeuvre
hund	hund
doggie	doggie
dogs	hundar
saufen	dricka
drinks	drinkar
anfeuern	köra/enhet
drizzle	duggregn
trocken	torr
ente	anka/and/ducka
jede	varje
adler	örn
eagles	örnar
eaglet	eaglet
ohr	öra
earache	earache
eardrum	eardrum
eardrums	eardrums
earlobe	earlobe
früh	tidig
erringen	förtjäna
earning	earning
earphones	earphones
earring	earring
ohrring	earrings
ohren	öron
boden	jorden
erdbeben	jordbävning
earthquakes	jordbävningar
earths	earths
regenwurm	daggmask
earthworms	earthworms
earwax	earwax
ease	lätthet
arbeitsbock	staffli
easier	lättare
leichteste	lättaste
easily	med lätthet
easiness	easiness
orient	östra
ostern	påsk
leicht	lätt
essen	äta
eatable	eatable
eats	äter
ebony	ebenholts
eccentric	original/originell
eccentricity	eccentricity
geistlich	ecclesiastic
echo	eko
eclipse	månförmörkelse/förmörka
ecologic	ecologic
ecologist	miljöforskare
ecology	miljöforskning
economics	nationalekonomi
ecru	ecru
acht	åtta
achtzehn	arton
eighteenth	eighteenth
eightfold	eightfold
eighth	åttonde
eighties	åttitalet
eightieth	eightieth
achtzig	åttio
eightyfold	eightyfold
einsteinium	einsteinium
jede	varje
ausrufen	utropa
ejaculated	ejaculated
ejaculates	ejaculates
ejaculating	ejaculating
ejaculation	utrop
ejaculations	ejaculations
ejaculatory	ejaculatory
eject	tar ut
ejectable	ejectable
ejecting	ejecting
ejection	ejection
ejector	ejector
ejectors	ejectors
elaborate	genomarbeta/utveckla
elaborated	elaborated
elaborates	genomarbetar/utvecklar
elaborating	elaborating
ausarbeitung	elaboration
elaborations	elaborations
aufzug	hiss
elf	elva
eleventh	eleventh
ausschalten	avlägsna
beschließen	slut/avsluta
milieu	miljö
bote	sändebud
beneiden	avund/avundas
beneiden	avund/avundas
rolltreppe	rulltrappa
gründen	etablera
begebenheit	händelse
etwaig	eventual
gegebenfalls	eventuellt
ehemals	någonsin
evergreen	evergreen
endlos	ständig/evig
jede	varje
allenthalben	överallt
eviction	vräkning
erweis	bevis
ausrufen	utropa
fabel	fable
fables	fables
gewebe	tyg
fabricant	fabricant
anfertigen	uppfinna/förfalska
fabricated	fabricated
fabricates	fabricates
fabricating	fabricating
fabrication	påhitt/lögn
fabrications	fabrications
fabricator	fabricator
fabricators	fabricators
fabrics	tyger
fabulist	fabulist
fabulous	fabulous
fassade	facade
facades	facades
faceless	faceless
faceplate	faceplate
facet	facet
scherzhaft	skämtsam
scherzhaft	skämtsam
facetiously	facetiously
facial	ansikts-
facies	facies
geläufig	facile
erleichtern	underlätta
facilitated	främjandet
facilitates	facilitates
facilitating	facilitating
möglichkeiten	möjligheter
hilfsmittel	hjälpmedel
facing	vara vänd mot
facsimile	faksimil
tatsache	faktum
fraktion	parti/partigrupp/split
factor	faktor
fakultaet	factorial
factorials	factorials
factories	fabriker
factorization	factorization
factorizations	factorizations
factorize	factorize
factorized	factorized
factors	faktorer
fabrik	fabrik
facts	fakta
faktisch	factual
facultative	facultative
facultatively	facultatively
faculties	faculties
fakultät	förmåga/fakultet
fad	vurm/mani
erblassen	tyna
faded	tynade
fader	fader
faders	faders
fading	fading
faery	faery
faience	faience
unterlassen	fela
flau	svimma/svag
faintly	faintly
basar	skaplig/ärlig
ziemlich	tämligen/ärligt
fee	fe
gläubig	trogen
faithfully	troget
fashionable	modern/elegant
schnell	snabbt
fastener	fäste
wählerisch	kräsen
dick	fet
fatal	ödesdigert/dödlig
fatalism	fatalism
fatality	svår olycka
fatally	fatally
bestimmung	ödet
fischen	fisk
fishable	fishable
fishbowl	fishbowl
fished	fished
fisher	fisher
fisheries	fisheries
fisherman	fiskare
fishermen	fishermen
fishers	fishers
fishery	fishery
fishes	fishes
angeln	fisket
fishtail	fishtail
fission	klyvning
fissionable	fissionable
fissure	klyfta/klyvning
faust	knytnäve
fisted	fisted
fistful	fistful
fünf	fem
fivefold	fivefold
anberaumen	laga
fixation	fixation
fixations	fixations
fixity	fixity
fixture	fast tillbehör
fixtures	fixtures
fjord	fjord
fjords	fjords
flug	flygtur
diskette	diskett
fluently	fluently
fuß	fot
fußball	fotboll
vergessen	glömma
vergeßlich	glömskt
forgetfulness	glömska
forgivable	forgivable
forgivably	forgivably
entschuldigen	förlåt
forgiveness	förlåtelse
forgives	forgives
forgiving	forgiving
forgo	avstå från/uppge
forgoes	forgoes
forgotten	glömd
forlorn	övergiven/hopplös
formaldehyde	formaldehyde
vier	fyra
fuchs	räv
fractal	fraktal
fractals	fraktaler
fraktion	fraktion
fractionate	fractionate
fraternal	broderlig
fraternize	fraternize
freundin	vän
freundschaft	vänskap
fringe	frans/kanta
frosch	groda
frogs	frogs
als	från
front	fram
fucked	knullad/knullade
fudge	fudge
fugue	fugue
fulgurant	fulgurant
angst	rädsla
funniest	roligaste
drollig	kul
gab	prat
gabardine	gabardine
gabber	gabber
gabbing	gabbing
gaberdine	gaberdine
hilfsmittel	hjälpmedel
freuen	glädje
frohes	glatt
errungenschaft	vinna
gained	vunnit
gaining	gaining
gala	gala
galactic	galactic
galaxy	lysande samling
brav	tapper/artig
gallantly	gallantly
gallantry	gallantry
galleries	galleries
galerie	galleri/läktare
gallon	gallon
galopp	galopp/galoppera
galloped	galloped
galloping	galloping
galvanic	galvanic
galvanism	galvanism
galvanize	uppliva/galvanisera
galvanized	galvanized
aufführung	spel
spiels	spel
knoblauch	vitlök
gas	gas/gasa/prat/bensin
benzin	bensin
ghostwriter	ghostwriter
angebinde	present
gifts	gåvor
fahren	gå/starta
ziel	mål
ziel	mål
ziege	get
gott	gud
goddess	gudinna
goddesses	gudinnor
gevatter	godfather
bucht	golf
golfer	golfer
golfers	golfers
golfs	golfs
gut	bra
gut	bra
adieu	adjö
goodnight	godnatt
gopher	gopher
kleid	klänning/dräkt
greifen	gripa tag i
gradient	stigning
allmählich	gradvis
grammatik	språklära
traube	druva
die grapefruit	grapefruit
habilitated	habilitated
habilitation	habilitation
angewohnheit	vana
habitant	habitant
habitants	habitants
habitat	naturlig hemvist
hausen	boning/boningsplats
habitual	sed/sedvanlig
hatte	hade
einhändigen	hand
führen	huvud
heats	heats
himmel	himmelskt
schwer	tung
hectare	hectare
hectares	hectares
hectoliter	hectoliter
igel	igelkott
heed	bekymra sig om
ferse	häl/klack/klacka
heeler	heeler
heels	heels
höhe	höjd
hielt	höll
helices	helices
dschehenna	helvete
hello	hallå/hej
lenkrad	roder/styre
helm	hjälm
hilfe	hjälp
hanf	hampa
huhn	höna
herd	hjord/skock
hierher	här
reiher	häger
hips	höfter
hauen	träff
hockey	hockey
hogwash	hogwash
holidayer	holidayer
holidays	ledigheter
nach hause	hem
homeless	hemlösa
heim	hem
haus	hus
eis	is
instancing	instancing
internship	internship
jab	stöt/stöta/sticka
jabber	rotvälska/pladder/pladdra
jabberwocky	jabberwocky
jabberwocky	jabberwocky
bube	domkraft
schakal	schakal
jackals	jackals
jackass	åsnehingst
jackdaw	kaja
jacke	jacka/rock
jacke	jacka/rock
jackknife	jackknife
jackpot	pott
strapazieren	hästkrake/jade
abgenutzt	utsliten/blaserad
jag	jag
uneben	ojämn
gefängnis	fängelse
gefängnis	fängelse
jailbreak	jailbreak
jailed	jailed
jailer	fångvaktare
jailing	jailing
jailor	jailor
jails	fängelser
jalopy	rishög
konfitüre	klämma/blockera/sylt
konfitüre	klämma/blockera/sylt
jamb	karm
jammed	packad
jammed	packad
jangle	gnissla/oljud
der hausmeister	portvakt
der hausmeister	portvakt
jar	burk/gräla/gnissla
jar	burk/gräla/gnissla
jar	burk/gräla/gnissla
jargon	rotvälska/jargong
jasmine	jasmin
jaundice	gulsot
jaunt	utfärd
jaunty	ogenerad/nonchalant
javelin	spjut
kiefer	käke
maul	käkar
eichelhäher	nötskrika
jazz	jazz/snack/pigga upp
jazzy	jazzig/gräll
eifersüchtig	svartsjuk
eifersucht	avundsjuka
jeer	hån/håna
jeer	hån/håna
gelee	gelé
die qualle	jellyfish
jeopardize	äventyra
jeopardize	äventyra
erschüttern	ryck/rycka/stöt
erschüttern	ryck/rycka/stöt
deutschem	tysk
jersey	tröja/ylletröja
jersey	tröja/ylletröja
scherzen	skämt/skämta
hanswurst	skämtare
hanswurst	skämtare
jet	stråle/låga/jet
jet	stråle/låga/jet
jettison	kasta överbord
jetty	pir/kaj/brygga
gemme	juvel
jeweler	jeweler
jewelery	jewelery
jewelry	jewelry
jewels	juveler
jib	klyvare/streta emot
jib	klyvare/streta emot
augenblick	ögonblick
jig	jigg
jigsaw	lövsåg
jihad	heligt krig
jilt	trolös/kvinna/svika
klimpern	klirra/klirrande
klimpern	klirra/klirrande
klimpern	klirra/klirrande
jinx	dra olycka
nervosität	nervositet/panik
arbeit	arbete
arbeit	arbete
arbeit	arbete
arbeitslos	arbetslös
jockey	jockej
jovial	skämtsam
jocund	glad/glättig/munter
jodhpur	jodhpur
jog	knuffa/lunka
jogging	jogging
verbinden	gå med
verbinden	gå med
joinable	joinable
joined	gått med
joiner	möbelsnickare
joinery	snickeri
fuge	skarv
fuge	skarv
fuge	skarv
gemeinsames	gemensamt
scherzen	skämta
scherzen	skämta
joked	skojade
joker	skämtare
jokingly	på skämt
jokingly	på skämt
jolly	glad/väldigt
erschüttern	skaka/skakning
erschüttern	skaka/skakning
jonquils	jonquils
jostle	knuffa/knuffas
jot	jota/annotera
jot	jota/annotera
journal	dagbok/tidning
journal	dagbok/tidning
journalism	journalistik
journalist	journalist
journalists	journalister
reise	resa
reise	resa
gemütlich	gemytlig
jovially	jovially
freude	glädje
joyful	glad/glädjande
joyless	glädjelös
joyously	joyously
jubelfeier	jubileum
richten	domare
richten	domare
judged	dömts
urteil	omdöme
judicial	rättslig
judiciary	domarna
judo	judo
kanne	krus/tillbringare
kanne	krus/tillbringare
kanne	krus/tillbringare
juggernaut	gudabild
gaukeln	jonglera
jongleur	jonglör
jugular	halsblodåder
saft	saft
juiceless	saftlös
juicier	juicier
juiciest	juiciest
juicy	saftig
jukebox	jukebox
bewegen	röra
jumbo	klumpeduns
springen	hoppa
jumped	hoppade
jumpy	nervös
union	knutpunkt
union	knutpunkt
jungle	jungel
junior	yngre/lägre
juniper	enbuske
junk	lump/skräp/djonk
junk	lump/skräp/djonk
junk	lump/skräp/djonk
junk	lump/skräp/djonk
junkers	junkers
junkers	junkers
junkie	knarkare
junkie	knarkare
junkyard	junkyard
juridic	juridic
jurisdiction	rättskipning
jurist	rättslärd
juror	jurymedlem
jurors	jurors
geschworene	jury/nämnd
billig	bara
gerechtigkeit	rättvisa/rätt
justified	rättfärdigat
justify	rättfärdiga
justly	rättvist
jut	sticka fram
juvenile	ungdomlig
juxtapose	placera vid sidan
kohl	kål
kaleidescope	kaleidescope
kaleidoscope	kaleidoscope
kängeruh	känguru
karat	karat
karate	karate
kayak	kayak
kebab	kebab
kiel	köl
bewahren	fortsätta/behålla
keeps	behåller
andenken	suvenir
keg	kagge/kutting
keg	kagge/kutting
kennel	hundkoja/hundgård
kennel	hundkoja/hundgård
kerchief	huvudduk
kern	kärna/korn
kern	kärna/korn
kern	kärna/korn
kerosene	fotogen
ketchup	ketchup
kessel	kittel
schlüssel/taste	tangent
schlüssel/taste	tangent
schlüssel/taste	tangent
tastatur	tangentbord
keyhole	keyhole
keying	keying
keynote	grundton/klav
keypad	keypad
khaki	khaki
stampfen	spark/sparka/kick
stampfen	spark/sparka/kick
kickback	motreaktion
kicked	kicked
kicker	kicker
kickoff	kickoff
kicks	kicks
zicklein	unge
zicklein	unge
zicklein	unge
kiddies	kiddies
kiddies	kiddies
kiddies	kiddies
kidnap	röva bort
kidnaped	kidnaped
kidnaper	kidnaper
kidnaper	kidnaper
kidnapers	kidnapers
kidnaping	kidnaping
kidnapped	kidnapped
kidnapper	kidnapper
kidnappers	kidnappers
kidnapping	kidnapping
kidnappings	kidnappings
niere	njure
kidneys	kidneys
kidneys	kidneys
kids	ungar
kids	ungar
ermorden	ta bort
ermorden	ta bort
killer	mördare
killer	mördare
killers	killers
killing	dödande
killing	dödande
killings	killings
killjoy	killjoy
herd	brännugn
kilogramm	kilo
kilogram	kilogram
kilohertz	kilohertz
kiloliter	kiloliter
kilometer	kilometer
kilowatt	kilowatt
kilt	kilt
verwand	släkt
freundlich	vänlig/sort
freundlich	vänlig/sort
freundlich	vänlig/sort
kindergarten	lekskola
kindergarten	lekskola
kindergarten	lekskola
kindergarten	lekskola
kindhearted	kindhearted
kindhearted	kindhearted
kindheartedness	kindheartedness
zünden	tända
zünden	tända
kindlessly	kindlessly
kindlessly	kindlessly
kindliness	kindliness
kindliness	kindliness
kindly	välvilligt
kindly	välvilligt
kindly	välvilligt
kindly	välvilligt
freundlichkeit	vänlighet
freundlichkeit	vänlighet
kindred	släktskap
kindred	släktskap
freundlicher	vänliga
freundlicher	vänliga
könig	kung
königreich	kungarike
königreich	kungarike
kingdoms	kungariken
eisvogel	kingfisher
kingly	konungslig
kings	kungar
kinky	krullig/excentrisk
kiosk	kiosk
kipper	rökt fisk/rökt sill
küssen	kysser/kyss
küssen	kysser/kyss
küssen	kysser/kyss
küssen	kysser/kyss
kisses	kyssar
kisses	kyssar
bausatz	utrustning/packning
bausatz	utrustning/packning
küche	kök
kitchenette	kokvrå
kitchens	kitchens
kitchenware	kitchenware
kitchenware	kitchenware
drachen	glada/drake
kith	släktingar
kiting	kiting
kätzchen	kattunge
kittens	kattungar
kitty	kitty
kiwi	kiwi
kiwi	kiwi
kleenex	kleenex
kleenex	kleenex
kleptomania	kleptomania
kleptomaniac	kleptomaniac
knack	knep/vana
knack	knep/vana
tornister	ryggsäck
kneten	knåda
kneadable	kneadable
kneader	kneader
knie	knä
kneecap	knäskål
kneel	knäböjer
kneel	knäböjer
kneeling	knäande
kneeling	knäande
kneepad	kneepad
knelt	knäböjde
knelt	knäböjde
knickers	dambyxor
knickknack	knickknack
knickknack	knickknack
messer	kniv
messer	kniv
knifes	knifes
knifing	knifing
kämpe	riddare/adelsman/adla
kämpe	riddare/adelsman/adla
knighted	knighted
knighthood	knighthood
knightly	knightly
knights	knights
stricken	sticka/rynka
stricken	sticka/rynka
stricken	sticka/rynka
knitted	knitted
knitting	stickning
knitwear	trikåvaror
knives	knivar
gefäß	vred
gefäß	vred
knobby	knölig
knobs	knobs
klopfen	slå
knockdown	knockdown
knockout	knockout
knoten	knut/knop
knots	knots
knotted	knölig
knotty	knölig/kvistig
kennen	veta
knower	knower
knowhow	knowhow
knowhow	knowhow
weiss	veta
knowingly	medvetet
knowingly	medvetet
begriff	kunskap
begriff	kunskap
kundig	kunnig
known	kända
weisst	vet
knuckle	knoge
knuckle	knoge
knucklebone	knucklebone
knuckles	knogar
koala	koala
koala	koala
kosher	kosher
kraut	kraut
kraut	kraut
krauts	krauts
kudzu	kudzu
lab	labb
arbeiten	arbeta
arbeiter	laborer
arbeiter	laborer
laborers	laborers
spitze	snöre/snöra/spets/spetsar
laceration	laceration
lacerations	lacerations
fehlen	avsaknad
lackadaisical	lackadaisical
bedienter	lakej
lacking	bristen
lackluster	lackluster
laconic	laconic
laconically	laconically
firnissen	fernissa
firnissen	fernissa
junge	pojke
damen	damer
dame	dam/kvinna
ladybird	ladybird
marienkäfer	ladybug
see	sjö
lakes	sjöar
lamm	lamm
lambs	lambs
laminated	laminated
laminates	laminates
lampe	lampa/lykta
sprache	språk
lachen	skratta
ledern	läder
abreisen	lämna
pult	läspulpet
vortrag	föreläsning/föreläsa
lektor	föreläsare
regal	hylla
ledger	huvudbok/liggare
lee	lä/läsida
bein	ben
legal	giltiga
legality	laglighet
legalize	legalisera
legally	lagligt
legate	påvlig legat
legation	legation
legende	legend/sägen
legendary	legendariska
legion	legion
epistel	brev
epistel	brev
epistel	brev
achten	gilla/som
hausen	leva
gern haben	älska/kärlek
gern haben	älska/kärlek
freier	älskare
glück	tur
lunch	lunch/luncha
mutti	mamma
mutti	mamma
maam	maam
maam	maam
maam	maam
macabre	makaber
macabre	makaber
macabrely	macabrely
macadam	makadam
macadam	makadam
macadamize	macadamize
macadamize	macadamize
macadamized	macadamized
macadamized	macadamized
macadamizes	macadamizes
macadamizes	macadamizes
macadamizing	macadamizing
macaque	macaque
macaque	macaque
makkaroni	macaroni
macaronies	macaronies
macaroon	macaroon
macaw	macaw
mace	spikklubba/spira
macerate	macerate
macerated	macerated
maceration	maceration
macerations	macerations
maces	maces
machete	machete
machination	intrig
machined	machined
machineries	machineries
maschinerie	maskiner
machines	maskiner
machinist	machinist
machinists	machinists
machismo	machismo
macho	macho
macrocephalic	macrocephalic
macrocosm	macrocosm
macroeconomics	macroeconomics
macroevolution	macroevolution
macroevolutionary	macroevolutionary
macroinstruction	macroinstruction
macromolecular	macromolecular
macromolecule	macromolecule
macromolecules	macromolecules
macropathological	macropathological
macropathology	macropathology
macrophage	macrophage
macrophages	macrophages
macrophagic	macrophagic
macroprocessor	macroprocessor
macroscopic	macroscopic
macrosimulation	macrosimulation
macrostructure	macrostructure
maculate	maculate
maculated	maculated
maculates	maculates
maculation	maculation
maculations	maculations
irre	vansinnig
irre	vansinnig
frau	min fru/fröken
madams	madams
maddened	maddened
made	gjorda/gjort
made	gjorda/gjort
mademoiselle	mademoiselle
mademoiselles	mademoiselles
meister	maestro
mafioso	mafioso
zeitung	tidning
magie	magiskt
zauberer	trollkarl
magicians	magicians
magistral	magistral
magistrally	magistrally
magistrature	magistrature
magma	magma
mir	jag/mig
mead	mjöd/äng
anger	äng
anger	äng
meadowland	meadowland
meadows	ängen
mager	meager
meagerly	meagerly
meagre	mager/torftig
mehl	mål
meals	meals
beabsichtigen	mena/betyda/tarvlig
sich schlängeln	slingra sig
meaningless	meaningless
bedeutung	betydelse
bedeutet	menas
fleisch	kött
meats	meats
meatball	meatball
meatballs	meatballs
mechaniker	mekaniker
mechanician	mechanician
mechanism	mekanism
mechanisms	mekanismer
denkmünze	medalj
medallion	medaljong
medallions	medallions
mediatrice	mediatrice
mediatrix	mediatrix
medic	medic
medizinisch	medicinsk/läkar-
medically	medically
medicament	medicament
medicaments	medicaments
medicinal	medicinal
medizin	medicin
medicines	medicines
medico	medico
medicolegal	medicolegal
medics	medics
medieval	medeltida
medievalist	medievalist
medievalists	medievalists
mediocre	medelmåttig
mediocrity	mediocrity
erwägen	planera/meditera
meditates	meditates
meditation	meditation
meditations	meditations
meditative	meditative
mittels	mellan
medlar	medlar
medley	blandning/brokig
medleys	medleys
medulla	medulla
medusae	medusae
meek	ödmjuk
meekly	meekly
meekness	meekness
meerschaum	meerschaum
megabyte	megabyte
megabytes	megabytes
megacycle	megacycle
megahertz	megahertz
megalith	megalith
megalithic	megalithic
megalomania	megalomania
megalomaniac	megalomaniac
megalomaniacal	megalomaniacal
megaphone	megaphone
melancholia	melancholia
melancholic	melancholic
melange	melange
melodic	melodic
melodies	melodies
melodious	melodious
melodram	melodrama
melodramas	melodramas
melodramatic	melodramatic
melodie	melodi
melone	melon
melons	meloner
melted	melted
anhänger	medlem
members	medlemmars
membrane	membran
membranes	membranes
membranous	membranous
memoir	memoir
memoirs	memoarer
memorable	minnesvärd
memories	minnen
memorize	memorera
memorized	memorerat
männer	karlar
bevorstehen	hot
menagerie	menagerie
menageries	menageries
menhir	menhir
meningitis	meningitis
meniscus	meniscus
menopause	menopause
menstrual	menstrual
menstruation	menstruation
menstruations	menstruations
mental	sjäslig/sinnes-
mentality	mentality
menthol	menthol
nennen	nämna
menü	meny
meow	meow
meowing	meowing
meows	meows
mephitic	mephitic
mercantile	handels-/affärs-
mercantilism	mercantilism
mercenaries	mercenaries
mercenary	legosoldat
händler	köpman
merchants	köpmän
quecksilber	kvicksilver
barmherzigkeit	barmhärtighet
meridian	meridian
meridional	meridional
verdienen	förtjänst/förtjäna
meritocracy	meritocracy
merits	meriter
die meerjungfrau	sjöjungfru
mermaids	mermaids
wohlgemut	god
auskunft	meddelande
mitteilungen	meddelanden
messiahs	messiahs
messianic	messianska
ächzen	stöna
moaned	stönade
moaning	stönande
moans	stönar
moat	vallgrav
moats	moats
mob	mob
äffen	mock
mocked	mocked
spott	hån
modal	modal
mondschein	månljus/månsken
elch	älg
naiv	naiv
naively	naively
bloß	naken
name	namn/döpa
named	namngiven
nameless	anonym
zwar	nämligen
zwar	nämligen
names	namn/döper
national	nationell/riks-
nationalism	nationalism
nationalist	nationalist
angeboren	infödd
natürlich	naturlig
naturalize	naturalisera
natürlich	naturligtvis
neap	neap
beiläufig	i närheten
näher	närmare
unterlassen	försumma
nachbar	neighbor
neighbors	neighbors
garn	nätverk
networked	för nätverk
netzwerk	nätverk
neun	nio
neunzehn	nitton
nineteenth	nittonde
nineties	nineties
ninetieth	ninetieth
neunzig	nittio
ninetyfold	ninetyfold
ninth	ninth
niobium	niobium
nip	nypa/frostskada
zitze	smörjkopp
nipples	nipplar
nips	nips
nirvana	nirvana
nitrate	nitrat
nitrated	nitrated
nitrates	nitrates
nitrating	nitrating
nitration	nitration
nitrations	nitrations
nitric	salpeter
nitride	nitrera
stickstoff	kväve
nitroglycerin	nitroglycerin
nitroglycerine	nitroglycerine
edel	adlig/ädel
adeliger	adelsman
noblemen	noblemen
edelmut	nobleness
keine	ingen
noctambulism	noctambulism
noctambulist	noctambulist
nocturn	nocturn
nocturnally	nocturnally
nu	nu
heutzutage	nu för tiden
noway	noway
noway	noway
oaf	idiot
oafishness	oafishness
eiche	ek
ruder	åra
oarsman	oarsman
oase	oas
hafer	havre
eid	ed/svordom
oatmeal	havremjöl
obdurate	förstockad
obedience	lydnad
folgsam	lydig
obelisk	obelisk
fett	fet
obesity	överdriven fetma/dästhet
ozean	ocean
ein	en
apfelsine	apelsin
oranges	oranges
orbit	kretslopp
orbital	orbital
orbits	orbits
orchester	orkester
orchestral	orchestral
orchestras	orchestras
orchestrated	orchestrated
befehlen	beställa/beställning
ordered	beställd
organismus	organism
organisms	organisms
organist	organist
organists	organists
einrichtung	organisation
organizations	organisationer
einrichten	organisera
organized	organiserad
organs	organ
orgasm	orgasm
orgasms	orgasmer
orgies	orgies
orgie	orgie/utsvävning
orient	orienten
orientable	orientable
orientation	orientering
orientations	orientations
oriented	orienterad
orients	orients
orifice	öppning
orifices	orifices
orificial	orificial
ursprung	ursprung
ursprünglich	original/ursprunglig
originality	äkthet
originally	ursprunligen
originals	originals
origins	origins
ornamental	ornamental
ornithology	ornithology
orthodox	orthodox
orthodoxes	orthodoxes
orthogonal	orthogonal
schreiten	fart
schreiten	fart
pachyderm	pachyderm
stillen	stilla
pacifically	pacifically
pacification	pacification
pacifications	pacifications
pacificist	pacificist
pacifier	pacifier
pacifism	pacifism
pazifist	pacifist
pacify	lugna/stilla
pacify	lugna/stilla
packen	paket
packen	paket
packaged	packaged
packaged	packaged
packed	packad
bündel	litet paket
packing	frakt
pact	fördrag
pacts	pacts
block	kudde
padding	stoppning
paddeln	paddel/paddla
paddock	hästhage/sadelplats
vorhängeschloss	hänglås
vorhängeschloss	hänglås
padrone	padrone
paella	paella
pagan	hedning/hednisk
pagans	hedningar
pageant	festtåg
pageantry	pageantry
paid	betalad
eimer	hink
schmerz	smärta
pained	pained
painful	smärtsam
painful	smärtsam
painfully	smärtsamt
painstaking	noggrann
färben	måla
färben	måla
pinsel	paintbrush
maler	målare
painters	painters
bild	tavla/målning
paints	målar
paar	par
schlafanzug	pyjamas
genosse	vän
genosse	vän
palast	palats
palatable	smaklig
palaver	palaver
blaß	blek
palette	färgkarta
pall	bårtäcke/äcklas
pallet	brits/hård bädd
pallette	pallette
pallor	pallor
handfläche	handflata
handfläche	handflata
palpable	kännbar
palpable	kännbar
paltry	usel
broschüre	broschyr
pan	panna/kastrull/skål
panacea	panacea
panama	panama
fladen	pancake
der panda	panda
pandemonium	pandemonium
pane	fönsterruta
paneel	ruta/fält/panel
paneling	paneling
panelling	panelling
pang	smärta/styng
panik	få panik
panik	få panik
panicky	panicky
panorama	panorama
stiefmütterchen	pensé
pant	flämta/flämtning
panther	panther
unterhose	trosor
speisekammer	skafferi
beinkleid	byxor
papa	papa
dokument	papper/tidning
broschüre	pocketbok
parameter	parameter
passer	passer
glut	lidelse/vrede
passionately	passionerat
passive	passiv
passivity	passivity
passwort	lösenord
passwords	passwords
vergangenheit	förbi
pasta	pasta
pectorals	pectorals
befremdend	egendomlig
penitence	ånger
penitences	penitences
penitency	penitency
penitent	ångerfull
pentadactyl	pentadactyl
pentadactylism	pentadactylism
pi	pi
pianist	pianist
pianistic	pianistic
ansicht	bild
pictures	bilder
pastete	tårt
pies	pies
schwein	gris
abteilung	pigeonhole
pigment	pigment
pigmentation	pigmentation
pigments	pigments
pigs	pigs
lotsen	lots/lotsa/pilot
pilots	pilots
pilule	pilule
föhre	barrträd/tall/tyna/tyna bort
ananas	ananas
pineapples	pineapples
pines	pines
rosa	rosa
tasche	fickan
brieftasche	plånbok
pocketbooks	pocketbooks
pockets	pockets
podium	podium
pogrom	pogrom
pogroms	pogroms
zeiger	pekare
pointillism	pointillism
pointillist	pointillist
pointilliste	pointilliste
pointillistic	pointillistic
vergiften	gift
giftig	giftig
poisonousness	poisonousness
poisons	poisons
polar	polar
polarities	polarities
polarity	polarity
polarize	polarize
polarized	polarized
polemical	polemical
polemically	polemically
polemicize	polemicize
polizei	polisen
polizist	polis
polizist	polis
polizist	polis
policemen	policemen
policemen	policemen
policemen	policemen
policewoman	policewoman
policewomen	policewomen
polize	politik
polnisch	glans/polera/polska
polnisch	glans/polera/polska
artig	artig
politely	politely
politeness	artighet
politisch	politisk
politically	politiskt
politician	politiker
politicians	politicians
politik	politik
polka	polka
pollutant	förorenande ämne
pollute	orena/förorena
polluted	polluted
polluter	polluter
pollution	miljöförstöring
polonium	polonium
poltergeist	poltergeist
polyandrous	polyandrous
polyandry	polyandry
gießen	hälla
schmollen	tjura
armut	fattigdom
pudern	krut/pulver/puder
powdery	powdery
gewalt	kraft
gewältig	kraftfull
powerless	powerless
powwow	powwow
practicability	practicability
gangbar	genomförbar
praktisch	praktisk
beten	bedja
gebet	bön
prayers	böner
praying	praying
praying	praying
predigen	predika
predigen	predika
preacher	preacher
preacher	preacher
preachers	preachers
preachers	preachers
preaches	predikanter
preaches	predikanter
preachify	preachify
preaching	predikandet
preaching	predikandet
preaching	predikandet
preachy	preachy
preachy	preachy
preamplifiers	preamplifiers
prearrange	prearrange
prearrange	prearrange
fürst	prince
princedom	princedom
princely	princely
princes	princes
fürstin	princess
hauptsächlich	huvudsaklig
hauptsächlich	huvudsaklig
principalities	principalities
fürstentum	furstendöme
besonders	principally
besonders	principally
principals	principals
grundsatz	princip
principles	principles
drucken	skriva ut
drucken	skriva ut
drucken	skriva ut
ausgedruckt	utskriven
drucker	skrivare
drucker	skrivare
priorities	priorities
priorities	priorities
priorität	prioritet
begründen	bevisa
puls	pulsera
pulverizable	pulverizable
pulverizables	pulverizables
pulverization	pulverization
mahlen	pulverize
pulverized	pulverized
pulverizer	pulverizer
pulverizers	pulverizers
pulverizes	pulverizes
pulverizing	pulverizing
puma	puma
pumpen	pump
dringen	trycka
pushchair	pushchair
pushing	trycker/tryckande
legen	placera/uttrycka
putdown	putdown
putout	putout
putrefaction	putrefaction
wachtel	vaktel/bäva/förlora modet
quails	quails
quake	skälva/skalv
art	kvalitet
qualm	oro/illamående
qualms	samvetskval
menge	mängd
disput	gräl
quarry	byte/stenbrott
quartier	fjärdedel
quarterdeck	quarterdeck
quarterfinal	quarterfinal
königin	drottningen
wunderlich	underlig
erdrosseln	undertrycka/kuva
quench	släcka/undertrycka
querulous	gnällig
anfrage	förfrågan
nachsuchung	sök/sökande
frage	fråga
queue	köa
schikanieren	rida på ord/slingra sig
geschwind	snabb
quicklime	quicklime
flugs	snabbt
quicksand	kvicksand
quecksilber	quicksilver
fromm	tyst
quieten	quieten
quietly	tystlåtet
quill	gåspenna
steppen	sängtäcke
quirk	sarkasm/besynnerlighet/snirkel
abdanken	sluta
sehr	ganska
quote	kvot
zitat	citat
anführen	ange
r	r
rabbet	rabbet
rabbiner	rabbi
rabbinic	rabbinic
kaninchen	kanin
rabbits	kaniner
gesindel	slödder
rabid	galen/arg
tollwut	rabies
raccoon	raccoon
abkunft	tävling/ras
racehorse	tävlingshäst
racemic	racemic
racer	racer
races	races
rachis	rachis
rachitic	rachitic
rachitis	rachitis
racialism	racialism
racialist	racialist
racialistic	racialistic
racing	racing
racism	racism
racist	racist
arrak	ställning
schläger	oväsen/bedrägeri/racket
schläger	oväsen/bedrägeri/racket
radar	radar
radars	radars
radio	radio
lesen	läsa
lesbarkeit	läsbarhet
readable	läsbar
reader	läsare
readers	läsarna
readership	readership
readership	readership
gern	gärna
gern	gärna
gern	gärna
readiness	villighet
readiness	villighet
lesung	läser
lesung	läser
lesung	läser
readings	readings
readings	readings
readjust	revidera
readjusts	readjusts
readjusts	readjusts
readout	avläsning
readout	avläsning
readouts	readouts
reads	läser
bereit	klar
bereit	klar
bereit	klar
reaffirm	på nytt bekräfta
reaffirm	på nytt bekräfta
reaffirms	reaffirms
reaffirms	reaffirms
reagent	reagent
effektiv	riktig
effektiv	riktig
effektiv	riktig
realisable	realisable
realism	realism
realist	realist
realistic	realistiskt
realistic	realistiskt
realistically	realistically
wahrheit	verkligheten
begreifen	förstå
tatsächlich	verkligen
reporter	reporter
abbilden	representerar
bitten	begäran/efterfråga
bitten	begäran/efterfråga
bitten	begäran/efterfråga
bahn	väg
roads	vägar
roadwork	roadwork
freibeuter	rövare
rotting	rotting
sabbat	sabbat
sabbat	sabbat
sabbatic	sabbatic
sabbatical	sabbats-
saber	saber
sabin	sabin
sable	sobel
sabot	sabot
sabotage	sabotage/sabotera
sabotaged	saboterad
sabotages	sabotage
saboteur	sabotör
sabra	sabra
sabras	sabras
saccade	saccade
saccharin	sackarin
saccharine	sackarin
saccharose	saccharose
sacerdotal	sacerdotal
sacerdotally	sacerdotally
sachet	portionspåse
abdanken	säck/avskeda/plundra
abdanken	säck/avskeda/plundra
sackcloth	sackcloth
sacked	sacked
sackful	sackful
sacks	sacks
sakrament	sakrament
sacramental	sakramental
sacraments	sacraments
sacre	sacre
heilig	helig
erbieten	offer/uppoffring/uppoffra
sacrificed	uppoffrat
sacrifices	sacrifices
sakrilegium	helgerån
düster	ledsen
sadden	göra ledsen
sadder	sadder
saddest	saddest
sattel	sadel
saddlebag	saddlebag
saddlebags	saddlebags
saddlebow	saddlebow
saddlecloth	saddlecloth
saddled	saddled
saddleless	saddleless
saddler	saddler
saddlery	saddlery
saddles	saddles
saddletree	saddletree
sadism	sadism
sadist	sadist
sadistic	sadistiska
sadistically	sadistically
sadists	sadists
sadly	ledsamt
betrübnis	sorg
safari	safari
sicher	säker
safecracker	safecracker
safecracking	safecracking
safeguard	skydd/säkra
safeguarded	safeguarded
safeguards	safeguards
safer	säkrare
safest	säkraste
sicherheit	säkerhet
safflower	safflower
saffron	saffron
sag	bågna/sjunka
saga	saga
einsichtsvoll	sagacious
sagaciously	sagaciously
sagaciousness	sagaciousness
sagacity	skarpsinne/klokhet
salbei	vis/salvia
sagely	sagely
sago	sago
saguaro	saguaro
sahib	sahib
sagte	sa
segel	segla
segel	segla
sailable	sailable
das segelboat	sailboat
sailboater	sailboater
sailcloth	sailcloth
sailors	sjömän
sails	sails
sainfoin	sainfoin
heiliger	helgon/sankt/sankta
sainted	sainted
sainthood	sainthood
saith	saith
sake	skull
salability	salability
salacious	salacious
salat	salad
salads	salads
der salamander	salamander
salaried	salaried
salaries	salaries
absatz	försäljning
saleable	säljbar
saleroom	saleroom
salesclerk	salesclerk
salesgirl	salesgirl
saleslady	saleslady
ladengehilfe	försäljare
salesmanship	salesmanship
verkäufer	försäljare
salespeople	salespeople
salesperson	salesperson
salesroom	salesroom
ladenfräulein	saleswoman
saleswomen	saleswomen
salient	framträdande/utskjutande
saline	salthaltig/saltdamm
salinity	salinity
salinometer	salinometer
salinometers	salinometers
speichel	saliva
salivary	salivary
salivate	salivate
salivated	salivated
salivates	salivates
salivating	salivating
salivation	salivation
sallies	sallies
blaß	gulblek/sälg
sallowish	sallowish
lachs	lax
salmons	salmons
aula	salon
salons	salons
salzen	salt/salta
saltwater	saltwater
saltworks	saltworks
saltwort	saltwort
salzen	salt
bekömmlich	hälsosam
salubrity	salubrity
heil	bärga/bärgning
salver	silverbricka
samba	samba
gleiche	samma
sampan	sampan
samphire	samphire
samurai	samurai
samurais	samurais
sand	sand
sandale	sandal
schule	skola
meer	hav/sjö/sjögång
veräußern	sälja
seller	säljare
sellers	sellers
serendipity	serendipity
heiter	lugn/fridfull
sieben	sju
sevenfold	sevenfold
siebzehn	sjutton
seventeenth	seventeenth
seventh	seventh
seventies	seventies
seventieth	seventieth
siebzig	seventy
seventyfold	seventyfold
sever	hugga av/skilja
streng	kännbara/stränga
severed	severed
severely	kännbart
severities	severities
severity	stränghet
sewage	avloppsvatten
geschlecht	kön
sexagenarian	sexagenarian
generisch	sexuell
sexually	sexuellt
shades	nyanser
schatten	skugga
shadows	skuggor
shagreen	shagreen
schah	shah
erschüttern	skaka
shakedown	shakedown
shaken	shaken
shaky	skakande/skral/svag
shaman	shaman
shamanism	shamanism
shampoo	shampoo
shampoos	shampoos
hammel	får
sheepherder	sheepherder
abfertigen	skepp
abfertigen	skepp
mist	skit
krank	sjukt
silber	silver
singen	sjunga
berufssänger	sångare
tauchen	sjunka
sechs	sex
sechzehn	sexton
sixteenth	sixteenth
sixties	sixties
sechzig	sextio
sixtyfold	sixtyfold
ausdehnung	storlek
rochen	skridsko/åka skridsko
skateboard	skateboard
skateboarder	skateboarder
skateboarding	skateboarding
skateboards	skateboards
skater	skater
skaters	skaters
skates	skates
skating	skating
geschicklichkeit	skicklighet
geübt	skicklig/yrkesutbildad
skilless	skilless
geübt	skicklig
himmel	himmel
lerche	lärka
skyscraper	skyscraper
snout	tryne
schneien	snö
snowball	snowball
schneeflocke	snöflinga
snowman	snögubbe
snowstorm	snowstorm
software	programvara
sorrily	sorrily
betrübnis	sorg
abart	sortera
sorted	sorterad
sorter	sorter
gemüt	själ
spectra	spectra
spectrum	spectrum
speculate	spekulera
speculation	spekulation
klammer	stapelvara/krampa/märla
stapled	stapled
die heftmaschine	stapler
staplers	staplers
staples	staples
stern	stjärna
stars	stjärnor
anstellen	starta
stifled	stifled
stärke	styrka
blödsinnig	dum
subjekt	ämne
erfolg haben	lyckas/efterträda
erfolg	framgång
sonne	sol
sunbathe	sunbathe
sonnig	sunny
suppressed	undertryckt
argwöhnen	misstänka
lästern	svär
tab	lapp/etikett
tab	lapp/etikett
tabernacle	tabernakel
tabelle	bord
tableau	tablå
tableaus	tableaus
tableaux	tableaux
tischtucher	bordsduk
tablecloths	tablecloths
tables	tabeller
tabelle	skrivblock
tablets	lertavlor
taboos	taboos
tachometer	tachometer
tachometers	tachometers
tacit	tyst/underförstådd
sterz	svans
schneidern	skräddare
tailored	tailored
tailors	tailors
frack	svansar
arbeit	uppgift
angaben	uppgifter
schmecken	smaka
tasted	smakade
fade	smaklös
zerreißen	riva sönder
zerreißen	riva sönder
zerreißen	riva sönder
zerreißen	riva sönder
teardrop	teardrop
tearful	tearful
tearfully	tearfully
tearfully	tearfully
teargas	teargas
tearjerker	tearjerker
tearless	tearless
tearless	tearless
tearoom	tearoom
tränen	tårar
tränen	tårar
tearstained	tearstained
tearstained	tearstained
tease	reta/retas
tease	reta/retas
tease	reta/retas
teasel	teasel
teaser	svår uppgift
teaser	svår uppgift
teases	teases
teases	teases
teases	teases
teasing	teasing
teasing	teasing
teasingly	teasingly
teasingly	teasingly
teaspoon	teaspoon
teaspoon	teaspoon
teaspoonful	teaspoonful
brust	spene
brust	spene
brust	spene
brust	spene
teatime	teatime
teats	teats
teats	teats
zehn	tio
tendencies	tendencies
stimmung	benägenhet/tendens
tenderfoot	tenderfoot
zärtlich	ömt
daher	thence
daher	thence
thenceforth	thenceforth
thenceforward	thenceforward
theocracy	theocracy
theocratic	theocratic
theodolite	theodolite
theologe	teolog
theologians	teologer
theological	theological
theologically	theologically
theologie	teologi
theorem	theorem
theorems	theorems
theoretical	teoretisk
theoretical	teoretisk
theoretically	theoretically
theoretician	theoretician
theoretician	theoretician
theoreticians	theoreticians
theoreticians	theoreticians
theorist	theorist
theorist	theorist
theorists	theorists
theorists	theorists
theorize	theorize
dieb	tjuv
obgleich	fastän
obgleich	fastän
gedanke	tänkte
gedanke	tänkte
thoughtful	tankfull
thoughtfully	thoughtfully
vorsorge	thoughtfulness
thoughtless	thoughtless
thoughtlessly	thoughtlessly
thoughtlessness	thoughtlessness
tausend	tusental
thousandth	thousandth
verhauen	klå/tröska
verhauen	klå/tröska
faden	tråd
faden	tråd
faden	tråd
threadbare	trådsliten/banal
bedrohung	hot
bevorstehen	hota
threatening	threatening
threateningly	threateningly
drei	tre
tigress	tigress
heute	idag
zehe	tå
tradition	tradition
traditionell	traditionell
geleise	spår
abrichten	tåg/träna
trainee	trainee
trainer	tränare
traitor	förrädare
transaction	transaktion
transalpine	transalpine
transcribe	transcribe
entern	överföring
übersetzen	översätta
übersetzung	översättning
übersetzer	översättare
schicken	sända
baum	träd
lastauto	lastbil/transportera
zwei	två
ubiquitous	allestädes närvarande
ubiquity	ubiquity
euter	juver
ugh	usch
uglier	uglier
ugliest	ugliest
uglify	uglify
uglily	uglily
ugliness	fulhet
häßlich	otäckt
ukulele	ukulele
geschwür	varigt sår/böld
ulcerate	ulcerate
ulcerated	ulcerated
ulceration	ulceration
ulcerative	ulcerative
ulna	ulna
ultimo	ultimo
arbeitlosigkeit	arbetslöshet
vacant	ledigt
vacate	utrymma
ferien	semester
impfen	vaccinera
vaccinated	vaccinated
vacuum	tomrum
vacuumed	vacuumed
vagina	slida
vagrant	luffare
vague	vag/svävande
vergebens	fåfäng
wacky	wacky
wag	vagga/vifta
walnuß	valnöt
geschäft	magasin
geschäft	magasin
warehouses	warehouses
spülen	tvätta
tränen	gråta
weeping	gråt
weeping	gråt
weeps	weeps
weepy	gråtmild
weepy	gråtmild
weevil	vivel
weft	inslag i väv
wägen	väga
wägen	väga
weighing	weighing
weighings	weighings
weighs	väger
gewicht	vikt
weighted	weighted
weighted	weighted
weightily	weightily
weighting	weighting
weighting	weighting
weightless	weightless
gewichtslosigkeit	weightlessness
weights	belastningar
weights	belastningar
schwer	tung
schwer	tung
weir	fördämning/damm
seltsam	konstig
weirdie	weirdie
weirdies	weirdies
weirdly	weirdly
weirdness	weirdness
weirdness	weirdness
weirdo	weirdo
weirdos	weirdos
weirs	weirs
willkommen	välkommen
willkommen	välkommen
willkommen	välkommen
willkommen	välkommen
war	var
fenster	fönster
fenster	fönster
windowpane	windowpane
windowpanes	windowpanes
windows	windows
windstorm	windstorm
wein	vin
wineglass	vinglas
winegrower	winegrower
winemaker	winemaker
winemaking	winemaking
winepress	winepress
wines	wines
winey	winey
fittich	vinge/flygel/eskader
winglet	winglet
zwinkern	blinka
winter	vinter
wischen	torka
draht	tråd/telegram/telegrafera
draht	tråd/telegram/telegrafera
draht	tråd/telegram/telegrafera
wired	wired
radio	trådlös/radio
wiring	kabeldragning
wiry	senig/seg
weisheit	klokhet
gescheit	klokt
wisecrack	kvickhet/kvickhuvud
wisely	klokt
wiser	wiser
wünschen	önskar
wünschen	önskar
wishbone	wishbone
wünsche	önskar
wishful	wishful
hexe	häxa
witches	witches
mit	med
zurückziehen	dra tillbaka
zurückziehen	dra tillbaka
ohne	utan
zeuge	bevittna
zeuge	bevittna
witnesses	vittnen
wolverine	järv
wolverine	järv
welt	värld
universal	världsomspännande
xenophobe	främlingsskräck
xenophobia	främlingsskräck
xenophobic	xenophobic
xerographic	xerographic
xylem	xylem
xylene	xylene
xylophone	xylophone
xylophones	xylophones
xylophonist	xylophonist
xylose	xylose
xylotomic	xylotomic
jacht	lustjakt
yachting	segling
yachtsman	seglare
yak	jak
yamswurzel	jams
yap	gläfsa
hof	gård
yardstick	tumstock
yarn	garn/skepparhistoria
gähnen	gäspa
gähnen	gäspa
yawning	gäspande
ja	ja
jahr	år
yearbook	årsbok
yearlong	yearlong
jährlich	årlig/årligen
jährlich	årlig/årligen
sich ersehnen	längta
yearning	längtande
yearningly	yearningly
jahr	år
yeast	jäst
heulen	vråla
heulen	vråla
gelb	gul
yellowed	yellowed
yellowing	yellowing
yellowish	yellowish
ja	ja
gestern	igår
noch	ännu
yew	idegran
abtreten	avkastning/vika sig
yoga	yoga
yoghurt	yoghurt
yogurt	yogurt
joch	ok
yolk	äggula
du/sie	du/ni
du/sie	du/ni
jung	ung
jüngere	yngre
jüngling	pojkspoling
jugend	ungdom
youthful	ungdomlig
yuppie	yuppie
zabaglione	zabaglione
zany	dumbom
zazen	zazen
eifer	iver/nit
eifrig	ivrig/nitisk
zebra	sebra
zenit	zenith
null	noll
null	noll
zest	krydda/aptit
im zickzack gehen	sicksack
zink	zink
reissverschluss	blixtlås
tierkreis	zodiac
tierkreis	zodiac
zone	zon/bälte
zone	zon/bälte
zoo	zoologisk trädgård
zoologie	zoologi
zoom	zoom
zucchini	zucchini
