un/una	ein
un/una	ein
aardvark	aardvark
aardvark	aardvark
aardvarks	aardvarks
hacia atrás	zurück
hacia atrás	zurück
hacia atrás	zurück
abacterial	abacterial
ábaco	abacus
ábaco	abacus
ábaco	abacus
abacuses	abacuses
abacuses	abacuses
abacuses	abacuses
abaft	abaft
abalone	abalone
abalones	abalones
abandonar	ablassen
abandonar	ablassen
abandoned	impertinent
abandoned	impertinent
abandoned	impertinent
abandonee	abandonee
abandoner	abandoner
abandoning	abandoning
abandono	zession
abandono	zession
abandonments	abandonments
rebajar	demütigen
abased	abased
abasement	abasement
abasements	abasements
abases	abases
confundir	beschämen
abashed	verlegen
abashed	verlegen
abasing	abasing
disminuir/decrecer	erschlaffen
disminuir/decrecer	erschlaffen
abated	abated
reducción	nachlaß
reducción	nachlaß
abatements	abatements
abates	abates
abating	abating
abating	abating
carnicería	abattoir
abbe	abbe
abberations	abberations
abadía	abtei
abadía	abtei
abbeys	abbeys
abad	abt
abad	abt
abad	abt
abad	abt
abad	abt
abbots	abbots
abreviar	abkürzen
abreviar	abkürzen
abbreviated	abbreviated
abbreviates	abbreviates
abbreviating	abbreviating
abreviación	verkürzung
abreviación	verkürzung
abreviación	verkürzung
abbreviations	verkürzungen
abbreviations	verkürzungen
abbreviator	abbreviator
abdicable	abdicable
abdicar	abdanken
abdicar	abdanken
abdicated	abdicated
abdicación	abdication
abdicator	abdicator
abdomen	hinterleib
abdomen	hinterleib
abdomens	abdomens
abdominal	den unterbauch betreffend
abdominally	abdominally
abducir	abduct
abducted	abducted
abducting	abducting
secuestro	abduction
abductions	abductions
secuestrador	abductor
abductors	abductors
abeam	quer
abecedarian	abecedarian
abed	abed
desvío	abweichung
aberrante	aberrant
aberrantly	aberrantly
aberración	aberration
aberración	aberration
aberrations	aberrations
instigar	agitieren
abetment	mithilfe
abets	abets
abetted	abetted
abetter	abetter
abetting	abetting
abettor	abettor
suspensión	ruhen
abeyant	abeyant
aborrecer	verabscheuen
abhorred	abhorred
horror	abscheu
horrible	abhorrent
abhorrently	abhorrently
abhorring	abhorring
abhors	abhors
aguardar	gewärtigen
abided	abided
abides	abides
continuo	fest
abilities	abilities
capacidad	kapazität
capacidad	kapazität
abiotic	abiotic
miserable/pobre	gemein
abjection	abjection
abjectly	abjectly
abjuration	abjuration
abjurar	annullieren
abjurer	abjurer
ablation	ablation
ablative	ablativ
ablaze	ablaze
ablaze	ablaze
capaz/hábil	begabt
capaz/hábil	begabt
capaz/hábil	begabt
capaz/hábil	begabt
abler	abler
ablest	ablest
abloom	abloom
ablution	ablution
ablutions	ablutions
hábilmente	ably
abnegate	abnegate
abnegates	abnegates
abnegation	aufopferung
anormal	abnormal
anormal	abnormal
anormal	abnormal
abnormalities	abnormalities
anormalidad	abnormalität
irregularmente	abnormally
a bordo	an bord
abode	wohnort
abodes	abodes
aboil	aboil
abolir	annullieren
abolir	annullieren
abolishable	abolishable
abolished	abolished
abolisher	abolisher
abolishes	abolishes
supresión	abolishment
abolición	abolition
abolición	abolition
abolitionism	abolitionism
abolitionist	abolitionist
abolitionists	abolitionists
abominable	abscheulich
abominably	abominably
abominar	verabscheuen
aversión/horror	abscheu
abominations	abominations
indígena	eingeboren
aboriginally	aboriginally
aborigine	aborigine
aborigines	aborigines
abortar	abortieren
aborted	aborted
aborter	aborter
aborting	aborting
aborto	fiasko
aborto	fiasko
abortionist	abortionist
abortionists	abortionists
abortions	abortions
abortivo	nutzlos
abortively	abortively
aborts	aborts
abundar	schwärmen
cerca	betreffs
encima de	oberhalb
aboveboard	aboveboard
aboveground	aboveground
abovementioned	abovementioned
abovementioned	abovementioned
abracadabra	abracadabra
abradable	abradable
abrade	hobeln
abrasion	abrasion
abrasions	abrasions
afilado	grell
abrasives	abrasives
abreast	abreast
abreviar	begrenzen
abridged	abridged
resumen	übersicht
abridging	abridging
en el extranjero	äußerlich
abrogar	annullieren
abrogated	abrogated
abolición	abrogation
escarpado	abgerissen
abruptamente	abruptly
abruptness	abruptness
absceso	abszeß
abscesses	abscesses
abscond	ausreißen
absconded	absconded
ausencia/falta	abwesenheit
absences	absences
ausente	abwesend
ausente	abwesend
absenteeism	absenteeism
absentees	absentees
absently	abwesend
absentminded	absentminded
absentmindedly	absentmindedly
absentmindedly	absentmindedly
absentmindedness	absentmindedness
absinth	beifuß
absinthe	beifuß
absoluto	absolut
absolutamente	freilich
absolution	begnadigung
absolutism	absolutismus
absolver	absolvieren
absolved	absolved
absolving	absolving
abssorber	absorbieren
absorbability	absorbability
absorbable	absorbable
absorbant	absorbant
absorbed	absorbed
absorbent	absorbent
absorbing	absorbing
absorption	absorption
abstenerse	abstain
abstained	abstained
abstemious	abstinent
abstention	abstinenz
abstentions	abstentions
abstinence	abstinenz
abstinent	abstinent
abstinently	abstinently
decudir	abstrakt
decudir	abstrakt
robo	diebstahl
abstruse	geheimnissvoll
absurd	abgeschmackt
absurdism	absurdism
absurdist	absurdist
absurdities	absurdities
absurdity	verdrehtheit
riqueza	reichtum
abundante	reichlich
abundantly	im überfluß
ofender	beleidigen
abused	abused
abusive	anzüglich
abusively	abusively
abut	abut
abuzz	abuzz
abysmal	unerforschlich
abysmally	abysmally
abismo	abgrund
abismo	abgrund
abysses	abysses
abysses	abysses
acacia	akazie
estudiante	student
academical	academical
academically	academically
academician	academician
academies	academies
academism	academism
academia	akademie
acanthus	akanthus
acanthuses	acanthuses
acordar	beipflichten
acordar	beipflichten
acelerar	beeilen
accelerated	accelerated
acceleration	acceleration
accelerations	accelerations
acelerador	accelerator
accelerators	accelerators
accelerometer	accelerometer
accelerometers	accelerometers
acento	accent
accented	betonte
accented	betonte
accents	accents
accentual	accentual
accentually	accentually
acentuar	betonen
accentuated	accentuated
accentuation	accentuation
aceptar	annehmen
aceptabilidad	acceptability
aceptable	acceptable
acceptably	acceptably
aceptación	annahme
accepted	accepted
accepter	accepter
acceptor	acceptor
acometida	anfall
accessed	accessed
accessibility	accessibility
alcanzable	zugänglich
adquisición	errungenschaft
accessorial	accessorial
accessories	zubehör
accessorize	accessorize
accessors	accessors
apéndice	accessory
accidente	unfall
accidental	zufällig
accidentalism	accidentalism
accidentalist	accidentalist
accidentally	accidentally
accidently	accidently
accidents	accidents
aplaudir	akklamieren
aplauso	beifall
acclimate	acclimate
acclimated	acclimated
aclimatar	akklimatisieren
accolade	accolade
accolades	accolades
acomodar	adaptieren
accommodated	accommodated
oficioso/servicial	entgegenkommend
acuerdo	einrichtung
accommodations	accommodations
accompanied	accompanied
accompanier	accompanier
accompanies	accompanies
accompaniment	geleit
accompaniments	accompaniments
accompanist	gefährte
accompanists	accompanists
acompañar	begleiten
accompanyist	accompanyist
accompanyists	accompanyists
accomplice	accomplice
accomplices	accomplices
realizar	erlangen
accomplished	accomplished
accomplishment	accomplishment
accomplishments	accomplishments
acorde	akkord
accordance	accordance
accorder	accorder
accorders	accorders
acordeón	ziehharmonika
accordionist	accordionist
accordionists	accordionists
accordions	accordions
accords	accords
accost	ansprechen
cuenta	konto
accountability	accountability
accountable	accountable
contador público	buchrevisor
accounting	buchführung
accouterment	accouterment
accrued	accrued
accruement	accruement
accumulated	accumulated
acetaminophen	acetaminophen
acetify	acetify
acetone	acetone
agrio	herb
acidic	acidic
allergen	allergen
allergen	allergen
allergic	allergic
allergies	allergies
allergies	allergies
alergia	allergie
alergia	allergie
alleviate	alleviate
alleviated	alleviated
calleja	gasse
calleja	gasse
alleys	alleys
alleys	alleys
alliance	verbindlichkeit
alliance	verbindlichkeit
alliances	alliances
alliances	alliances
allied	allied
allied	allied
alligator	alligator
alligator	alligator
alligators	alligators
alligators	alligators
alliteration	alliteration
alliteration	alliteration
alliterations	alliterations
alliterations	alliterations
allocate	allocate
allocated	allocated
allocation	allocation
allocation	allocation
allocations	allocations
allocution	allocution
allocution	allocution
allocution	allocution
allot	verlosen
permitir	lassen
allowable	zulässig
allowance	erlaubnis
allowed	erlaubt
alloy	legierung
alfabeto	alphabet
alphabetic	alphabetic
alphabetical	alphabetical
alphabetization	alphabetization
alphabetizations	alphabetizations
alfabetizar	alphabetize
alphabetized	alphabetized
alphabetizing	alphabetizing
alphabets	alphabets
alphamerical	alphamerical
alphanumeric	alphanumerisch
alphanumerical	alphanumerical
alphanumerically	alphanumerically
alphanumerics	alphanumerics
alpine	alpine
alpinism	alpinism
alpinist	alpinist
ya	bereits
también	auch
altercation	altercation
altercations	altercations
alternar	sich ablösen
alternated	alternated
alternately	alternately
entre	unter
amoral	amoral
amorous	amorous
amorously	amorously
amorphous	amorph
número/suma	anzahl
número/suma	anzahl
amp	amp
ampere	ampère
ampersand	ampersand
amphetamine	amphetamine
y	und
anyway	anyway
anywhere	irgendwo
aorta	aorta
apace	schnell
aparte	abgesondert
apartheid	apartheid
apartamento	appartement
apathetic	indolent
apathy	apathie
mono	affe
mono	affe
aperitif	aperitif
abetura	öffnung
apex	spitze
aphid	aphid
llegar	eintreffen
aspen	espe
controlar	kontrollieren
aula magna	auditorium
auditoriums	auditoriums
audits	audits
disponible	verfügbar
babble	quasseln
babbler	babbler
babies	babies
baboon	pavian
bebé	kinder
baccalaureate	baccalaureate
baccarat	baccarat
solterón	hagestolz
bachelors	bachelors
bacilli	bacilli
bacillus	bacillus
reverso	rücken
backache	backache
backbite	backbite
backbone	wirbelsäule
fondo	hintergrund
backgrounds	backgrounds
backside	after
backslide	backslide
backup	backup
atrasado	backward
tocino	speck
bacteria	bakterien
malo	böse
badge	insignien
badged	badged
badgers	badgers
badinage	badinage
bolso	beutel
bagatelle	lapalie
bagatelles	bagatelles
equipaje/equipajes	bagage
bags	bags
baguette	baguette
bah	bah
bail	bail
carnada/cebo	köder
bake	backen
panadero	bäcker
bakeries	bakeries
bakers	bakers
panadería	bäckerei
bakeshop	bakeshop
balance	saldo
balconies	balconies
balcón	altan
bald	kahlköpfig
baldhead	baldhead
baldly	baldly
baldness	baldness
bale	bale
baleen	baleen
balk	hindern
pelota	ball
ballad	ballade
ballade	ballade
ballads	ballads
lastre	ballast
ballet	ballett
balletic	balletic
globo	ärostat
balotaje	ballot
balls	balls
ballyhoo	ballyhoo
bálsamo	balsam
bambú	bambus
bamboozle	betrügen
plátano	banane
bananas	bananas
tira	bande
vendaje	bandage
bandeau	bandeau
bandido	bandit
bandits	bandits
bandleader	bandleader
bandmaster	bandmaster
bane	bane
banished	banished
barb	barb
bárbaro	barbar
barbarians	barbarians
barbarism	barbarismus
barbero	barbier
barmaid	barmaid
barman	barman
cuartel	kaserne
playa	strand
parir/oso	aushalten
parir/oso	aushalten
cauce	beet
bedroom	schlafzimmer
creer	glauben
betray	verraten
bibliographic	bibliographic
bibliographies	bibliographies
bibliography	bibliographie
zarzamora	brombeere
libro	buch
boomerang	boomerang
boxeador	boxer
chico/muchacho	junge
boys	boys
cerebro	gehirn
brood	brood
escoba	besen
broth	broth
construir	bauen
construcción	anbau
adiós	adieu
cabriolé	droschke
cabal	cabal
cabala	cabala
cabalism	cabalism
cabalist	cabalist
cabalistic	cabalistic
caballero	caballero
cabarét	cabaret
col	kohl
cabbages	cabbages
cabdriver	cabdriver
cabana	hütte
armario	kabinett
cabinetmaker	cabinetmaker
cabinetmakers	cabinetmakers
cabinets	cabinets
cabins	cabins
cable	kabel
cabled	cabled
cablegram	cablegram
cablegrams	cablegrams
cables	cables
cabling	cabling
cabman	chauffeur
caboose	caboose
cabotage	cabotage
cabriolet	cabriolet
cabs	cabs
cacao	cacao
cacciatore	cacciatore
cachalot	cachalot
cache	cache
cachepot	cachepot
caches	caches
cackle	cackle
cackled	cackled
cackles	cackles
cackling	cackling
cacophony	cacophony
cacti	cacti
cacto	kaktus
cad	cad
cadaver	kadaver
cadaverous	cadaverous
caddies	caddies
caddy	caddy
cadence	cadence
cadet	cadet
cadetship	cadetship
cadge	cadge
cadger	cadger
cafe	cafe
cafes	cafes
cafeteria	cafeteria
cafeterias	cafeterias
caffeine	caffeine
caftan	kaftan
cage	bauer
cages	cages
cahier	cahier
cairn	cairn
cairns	cairns
caitiff	caitiff
cajole	cajole
cajoler	cajoler
cajolery	cajolery
queque	kuchen
queque	kuchen
calcium	kalcium
calcular	erachten
calculated	calculated
calibrate	calibrieren
calibrated	calibrated
calibration	calibration
automóvil/coche	auto
carbonization	carbonization
carbonize	carbonize
carbonized	carbonized
carbonless	carbonless
carburetor	carburetor
carburetors	carburetors
carburization	carburization
carburize	carburize
carda	karte
cardamom	cardamom
cardiac	cardiac
cardigan	cardigan
cardioid	cardioid
cardioids	cardioids
cuidar/cuidado	sorge tragen
cuidar/cuidado	sorge tragen
cared	cared
carrera	karriere
circunspecto/prudente	bedächtig
carefully	sorgfältig
gato	katze
célula	karzer
cellular	cellular
probabilidad/oportunidad	zufällig
cerezas	die kirschen
iglesia	kirche
churches	churches
capa	mantel
cloaks	cloaks
reloj	uhr
clockmaker	clockmaker
clockwise	clockwise
cloister	cloister
clone	clone
nube	wolke
clouds	clouds
carbon	kohle
computador	computer
ordenadores	computers
comrades	comrades
concealed	concealed
conjuring	conjuring
contemplate	contemplate
contemplate	contemplate
contemplate	contemplate
contemplates	contemplates
contemplation	contemplation
contemplation	contemplation
contemplation	contemplation
contemplations	contemplations
contemplations	contemplations
contemplative	contemplative
contemporaneous	contemporaneous
contemporaneously	contemporaneously
contemporaries	contemporaries
contemporaries	contemporaries
contemporary	zeitgenössisch
contemporary	zeitgenössisch
desprecio	verachtung
desprecio	verachtung
contemptible	contemptible
contemptibly	contemptibly
contemptuous	contemptuous
contemptuous	contemptuous
contemptuously	contemptuously
contemptuously	contemptuously
contend	contend
contend	contend
contend	contend
contender	contender
contender	contender
contender	contender
contenders	contenders
contenders	contenders
contenders	contenders
contending	contending
contending	contending
contends	contends
contends	contends
content	inhalt
content	inhalt
content	inhalt
contento	zufrieden
contento	zufrieden
contentedly	contentedly
contentedness	contentedness
contention	contention
contention	contention
contention	contention
contentions	contentions
contentions	contentions
contentions	contentions
contentious	contentious
contentious	contentious
contentment	contentment
contents	inhalt
contents	inhalt
concurso	konkurrenz-prüfung
concurso	konkurrenz-prüfung
concurso	konkurrenz-prüfung
contestant	contestant
contestant	contestant
camita de niño	kinderbett
trinquete	coterie
cotillion	cotillion
cotillon	cotillon
cottage	häuschen
cottager	cottager
canapé	couch
toser	husten
coughs	coughs
calcular/computar	rechne
countenance	angesicht
counteract	counteract
counterbalance	counterbalance
anular/contramandar	countermand
countermarch	countermarch
counterplot	counterplot
counterpoint	counterpoint
counterpoise	counterpoise
counterweight	counterweight
countess	countess
countless	zahllos
campo/país	gefilde
countryman	countryman
countrywide	countrywide
county	county
embragar	ehepaar
couplet	couplet
cupón	coupon
valor	mut
courageous	beherzt
courageously	courageously
mensajero	courier
cursillo/curso/plato	kurs
courser	courser
grave/patio	den hof machen
cortés	artig
courteously	courteously
courteousness	courteousness
courtesy	courtesy
courthouse	courthouse
courtier	courtier
courtliness	courtliness
courtly	courtly
courtmartial	courtmartial
courtroom	gericht
courtship	courtship
prima/primo	base
cove	cove
covenant	vereinbarungen
cubrir	einband
covert	covert
covet	gelüsten
covetous	covetous
covetously	covetously
vaca	kuh
vaca	kuh
coward	coward
cowardice	cowardice
cowardly	cowardly
cower	kauern
cowherd	cowherd
cowl	kappe
coxcomb	coxcomb
coy	coy
coyly	coyly
coyness	coyness
coyote	coyote
cozily	cozily
cozy	cozy
crabapple	crabapple
crabbed	crabbed
hendedura	spalte
cracker	cracker
crackle	knistern
cradle	wiege
astucia	craft
craftily	craftily
crag	crag
cram	cram
cramp	cramp
cranberry	cranberry
grúa	kranich
cranium	cranium
crankiness	crankiness
cranky	cranky
crape	crape
choque	crash
crate	crate
crater	crater
crave	crave
craven	feig
crawl	kriechen
cangrejo	krebs
crayon	buntstift
craze	wut
crazily	crazily
crazy	irre
creak	fletschen
crema/desnatar	rahm
creamy	creamy
crease	zerknittern
cree	schaffen
creacion	creation
creator	creator
creature	gebilde
credence	credence
credential	credential
haber	kredit
creditable	creditable
creditably	creditably
creditor	gläubiger
credo	credo
credulity	credulity
credulous	leichtgläubig
credulously	credulously
creed	creed
creek	creek
creep	kriechen
creeps	creeps
cremate	brennen
cortar	mähen
cute	süss
cute	süss
cuteness	cuteness
cutoffs	cutoffs
cutout	cutout
corta	schneidet
cutter	cutter
cutting	cutting
cyanate	cyanate
cyanide	cyanide
cybernetic	cybernetic
cybernetician	cybernetician
cybernetics	cybernetics
bicicleta/ciclo	fahrrad
cyclic	cyclic
cyclical	cyclical
cyclist	cyclist
cyclists	cyclists
cycloid	cycloid
cycloidal	cycloidal
ciclón	wirbelwind
cyclonic	cyclonic
cyclopean	cyclopean
cyclotron	cyclotron
cilindro	walze
papa	väterchen
daddies	daddies
papa	väterchen
dads	dads
daffy	verrückt
daft	verrückt
daga	dolch
dahlia	dahlia
dahlias	dahlias
todos los días/a diario	täglich
daintier	daintier
amable/fino	delikat
lechería	milchgeschäft
dalmatian	dalmatian
dalmatians	dalmatians
obstrucción/presa	gehege
daño	beschädigen
daño	beschädigen
daño	beschädigen
daño	beschädigen
estropeado	damaged
estropeado	damaged
damager	damager
damagers	damagers
damages	schäden
damaging	damaging
dame	dame
dammit	dammit
damnation	damnation
damned	damned
humedo	feucht
dampen	dampen
dampened	dampened
dampness	dampness
dams	dams
bailar/baile	ball
dancer	der tänzer
dancers	dancers
dancing	dancing
dandelion	hundebluhme
dandelions	dandelions
dandies	dandies
caspa	dandruff
peligro	gefahr
peligroso	besorglich
dardo	dart
día	tag
amanecer	tagesanbruch
daylight	daylight
días	tagen
deactivate	deactivate
deactivation	deactivation
muerto	sterblich
sordo	taub
deaths	deaths
profundo	tief
density	dichte
deserve	verdienen
detat	detat
detre	detre
aparato	apparat
aparato	apparat
dictated	dictated
dictates	dictates
dictation	dictation
dictations	dictations
dictionaries	wörterbücher
diccionario	wörterbuch
did	machte
morir	sterben
died	died
diesel	diesel
dieta	diät
dietetically	dietetically
diets	diets
diferente/disferente	verschieden
difficulties	schwierigkeiten
inconveniente	schwierigkeit
cavar	ausgraben
digested	digested
dignitaries	dignitaries
dignities	dignities
dignity	würde
dilate	erweitern
dilated	dilated
doctor/médico	doktor
doeuvre	doeuvre
perro	hund
doggie	doggie
perros	dogs
bebida/beber	saufen
drinks	drinks
propulsión	anfeuern
drizzle	drizzle
seco/árido	trocken
pato	ente
cada	jede
águila	adler
eagles	eagles
eaglet	eaglet
oreja	ohr
earache	earache
eardrum	eardrum
eardrums	eardrums
earlobe	earlobe
temprano	früh
ganar	erringen
earning	earning
earphones	earphones
earring	earring
arete	ohrring
ears	ohren
tierra	boden
terremoto	erdbeben
earthquakes	earthquakes
earths	earths
earthworm	regenwurm
earthworms	earthworms
earwax	earwax
ease	ease
caballete	arbeitsbock
easier	easier
easiest	leichteste
fácilmente	easily
easiness	easiness
este	orient
pascua	ostern
fácil	leicht
comer	essen
eatable	eatable
eats	eats
ebony	ebony
eccentric	eccentric
eccentricity	eccentricity
ecclesiastic	geistlich
echo	echo
eclipse	eclipse
ecologic	ecologic
ecologist	ecologist
ecology	ecology
economics	economics
ecru	ecru
ocho	acht
dieciocho/diez y ocho	achtzehn
decimooctavo	eighteenth
eightfold	eightfold
octavo	eighth
eighties	eighties
eightieth	eightieth
ochenta	achtzig
eightyfold	eightyfold
einsteinium	einsteinium
either	jede
ejaculate	ausrufen
ejaculated	ejaculated
ejaculates	ejaculates
ejaculating	ejaculating
ejaculation	ejaculation
ejaculations	ejaculations
ejaculatory	ejaculatory
eject	eject
ejectable	ejectable
ejecting	ejecting
ejection	ejection
ejector	ejector
ejectors	ejectors
trabajado	elaborate
elaborated	elaborated
elaborates	elaborates
elaborating	elaborating
elaboration	ausarbeitung
elaborations	elaborations
ascensor	aufzug
once	elf
eleventh	eleventh
eliminate	ausschalten
terminar/fin	beschließen
alrededores	milieu
embajador	bote
envidiar	beneiden
envidiar	beneiden
escalator	rolltreppe
edificar	gründen
acontecimiento	begebenheit
eventual	etwaig
eventually	gegebenfalls
ever	ehemals
evergreen	evergreen
everlasting	endlos
cada	jede
en todas partes	allenthalben
eviction	eviction
evidence	erweis
exclaim	ausrufen
fable	fabel
fables	fables
tela	gewebe
fabricant	fabricant
fabricar	anfertigen
fabricated	fabricated
fabricates	fabricates
fabricating	fabricating
fabrication	fabrication
fabrications	fabrications
fabricator	fabricator
fabricators	fabricators
fabrics	fabrics
fabulist	fabulist
fabulous	fabulous
frontón	fassade
facades	facades
faceless	faceless
faceplate	faceplate
facet	facet
facetious	scherzhaft
facetious	scherzhaft
facetiously	facetiously
facial	facial
facies	facies
fácil	geläufig
facilitate	erleichtern
facilitated	facilitated
facilitates	facilitates
facilitating	facilitating
facilities	möglichkeiten
facility	hilfsmittel
facing	facing
facsimile	facsimile
hecho	tatsache
partido	fraktion
factor	factor
factorial	fakultaet
factorials	factorials
factories	factories
factorization	factorization
factorizations	factorizations
factorize	factorize
factorized	factorized
factors	factors
fábrica	fabrik
facts	facts
factual	faktisch
facultative	facultative
facultatively	facultatively
faculties	faculties
faculty	fakultät
fad	fad
fade	erblassen
faded	faded
fader	fader
faders	faders
fading	fading
faery	faery
faience	faience
faltar	unterlassen
débil/desmayarse	flau
faintly	faintly
bazar/pasable	basar
fairly	ziemlich
fairy	fee
faithful	gläubig
faithfully	faithfully
fashionable	fashionable
rápido/pronto	schnell
fastener	fastener
fastidious	wählerisch
grueso/gordo	dick
fatal	fatal
fatalism	fatalism
fatality	fatality
fatally	fatally
destino	bestimmung
pez	fischen
fishable	fishable
fishbowl	fishbowl
fished	fished
fisher	fisher
fisheries	fisheries
pescador	fisherman
fishermen	fishermen
fishers	fishers
fishery	fishery
fishes	fishes
pesca	angeln
fishtail	fishtail
atomización	fission
fissionable	fissionable
fissure	fissure
puño	faust
fisted	fisted
fistful	fistful
cinco	fünf
fivefold	fivefold
fijar/reparar	anberaumen
fixation	fixation
fixations	fixations
fixity	fixity
fixture	fixture
fixtures	fixtures
fjord	fjord
fjords	fjords
vuelo	flug
flexible	diskette
fluently	fluently
pie	fuß
fútbol americano	fußball
olvidar	vergessen
forgetful	vergeßlich
forgetfulness	forgetfulness
forgivable	forgivable
forgivably	forgivably
perdonar	entschuldigen
forgiveness	forgiveness
forgives	forgives
forgiving	forgiving
forgo	forgo
forgoes	forgoes
forgotten	forgotten
forlorn	forlorn
formaldehyde	formaldehyde
cuatro	vier
zorro	fuchs
fractal	fractal
fractals	fractals
fraction	fraktion
fractionate	fractionate
fraternal	fraternal
fraternize	fraternize
amigo	freundin
amistad	freundschaft
fringe	fringe
rana	frosch
frogs	frogs
de/desde	als
frontón	front
fucked	fucked
fudge	fudge
fugue	fugue
fulgurant	fulgurant
funk	angst
funniest	funniest
cómico	drollig
gab	gab
gabardine	gabardine
gabber	gabber
gabbing	gabbing
gaberdine	gaberdine
gadget	hilfsmittel
gaiety	freuen
gaily	frohes
ganar/provecho	errungenschaft
gained	gained
gaining	gaining
gala	gala
galactic	galactic
galaxy	galaxy
gallant	brav
gallantly	gallantly
gallantry	gallantry
galleries	galleries
gallery	galerie
gallon	gallon
gallop	galopp
galloped	galloped
galloping	galloping
galvanic	galvanic
galvanism	galvanism
galvanize	galvanize
galvanized	galvanized
juego/partido	aufführung
juegos	spiels
ajo	knoblauch
gas	gas
bencina/gasolina	benzin
ghostwriter	ghostwriter
regalo	angebinde
regalos	gifts
ir/dirigirse	fahren
fin/objeto	ziel
goals	ziel
cabra	ziege
dios	gott
goddess	goddess
goddesses	goddesses
godfather	gevatter
golf	bucht
golfer	golfer
golfers	golfers
golfs	golfs
bueno	gut
bueno	gut
adiós	adieu
goodnight	goodnight
gopher	gopher
vestido	kleid
asir/coger	greifen
gradient	gradient
poco a poco	allmählich
gramática	grammatik
uva	traube
pomelo	die grapefruit
habilitated	habilitated
habilitation	habilitation
costumbre/hábito	angewohnheit
habitant	habitant
habitants	habitants
habitat	habitat
habitation	hausen
habitual	habitual
had	hatte
trabajador/mano	einhändigen
cabeza/efigie	führen
heats	heats
cielo	himmel
pesado	schwer
hectare	hectare
hectares	hectares
hectoliter	hectoliter
hedgehog	igel
acatar	heed
talón/tacón	ferse
heeler	heeler
heels	heels
altura/altitud	höhe
held	hielt
helices	helices
hell	dschehenna
hola	hello
timón/volante	lenkrad
casco	helm
ayuda/ayudar	hilfe
hemp	hanf
gallina	huhn
herd	herd
aquí/en ésta	hierher
heron	reiher
hips	hips
pegar a	hauen
hockey sobre hielo	hockey
hogwash	hogwash
holidayer	holidayer
holidays	holidays
hogar	nach hause
homeless	homeless
homes	heim
casa	haus
hielo	eis
instancing	instancing
internship	internship
jab	jab
jabber	jabber
jabberwocky	jabberwocky
jabberwocky	jabberwocky
gato	bube
jackal	schakal
jackals	jackals
jackass	jackass
jackdaw	jackdaw
chaqueta	jacke
chaqueta	jacke
jackknife	jackknife
jackpot	jackpot
cansar/fatigar	strapazieren
jaded	abgenutzt
jag	jag
jagged	uneben
prisión	gefängnis
prisión	gefängnis
jailbreak	jailbreak
jailed	jailed
jailer	jailer
jailing	jailing
jailor	jailor
jails	jails
jalopy	jalopy
mermelada	konfitüre
mermelada	konfitüre
jamb	jamb
jammed	jammed
jammed	jammed
jangle	jangle
portero	der hausmeister
portero	der hausmeister
jar	jar
jar	jar
jar	jar
jargon	jargon
jasmine	jasmine
jaundice	jaundice
jaunt	jaunt
jaunty	jaunty
javelin	javelin
mandíbula	kiefer
jaws	maul
jay	eichelhäher
jazz	jazz
jazzy	jazzy
celoso	eifersüchtig
jealousy	eifersucht
injuriar/insultar	jeer
injuriar/insultar	jeer
jelly	gelee
medusa	die qualle
jeopardize	jeopardize
jeopardize	jeopardize
jerk	erschüttern
jerk	erschüttern
jerry	deutschem
jersey	jersey
jersey	jersey
bromear	scherzen
jester	hanswurst
jester	hanswurst
jet	jet
jet	jet
jettison	jettison
jetty	jetty
joya	gemme
jeweler	jeweler
jewelery	jewelery
jewelry	jewelry
jewels	jewels
jib	jib
jib	jib
jiffy	augenblick
jig	jig
jigsaw	jigsaw
jihad	jihad
jilt	jilt
jingle	klimpern
jingle	klimpern
jingle	klimpern
jinx	jinx
jitters	nervosität
trabajo	arbeit
trabajo	arbeit
trabajo	arbeit
jobless	arbeitslos
jockey	jockey
jocular	jovial
jocund	jocund
jodhpur	jodhpur
jog	jog
correr	jogging
reunirse/juntarse	verbinden
reunirse/juntarse	verbinden
joinable	joinable
joined	joined
joiner	joiner
joinery	joinery
común	fuge
común	fuge
común	fuge
jointly	gemeinsames
broma/chanza	scherzen
broma/chanza	scherzen
joked	joked
joker	joker
jokingly	jokingly
jokingly	jokingly
jolly	jolly
jolt	erschüttern
jolt	erschüttern
jonquils	jonquils
jostle	jostle
jot	jot
jot	jot
journal	journal
journal	journal
journalism	journalism
periodista	journalist
journalists	journalists
viaje	reise
viaje	reise
jovial	gemütlich
jovially	jovially
alegría	freude
joyful	joyful
joyless	joyless
joyously	joyously
jubilee	jubelfeier
juez/juzgar	richten
juez/juzgar	richten
judged	judged
sentencia	urteil
judicial	judicial
judiciary	judiciary
judo	judo
jarra	kanne
jarra	kanne
jarra	kanne
juggernaut	juggernaut
juggle	gaukeln
juggler	jongleur
jugular	jugular
jugo/zumo	saft
juiceless	juiceless
juicier	juicier
juiciest	juiciest
jugosos	juicy
jukebox	jukebox
jumble	bewegen
jumbo	jumbo
saltar/salto	springen
jumped	jumped
jumpy	jumpy
unión/reunión	union
unión/reunión	union
jungla	jungle
junior	junior
juniper	juniper
junk	junk
junk	junk
junk	junk
junk	junk
junkers	junkers
junkers	junkers
junkie	junkie
junkie	junkie
junkyard	junkyard
juridic	juridic
jurisdiction	jurisdiction
jurist	jurist
juror	juror
jurors	jurors
jurado	geschworene
sólo/solamente	billig
justicia	gerechtigkeit
justified	justified
justify	justify
justly	justly
jut	jut
juvenile	juvenile
juxtapose	juxtapose
kale	kohl
kaleidescope	kaleidescope
kaleidoscope	kaleidoscope
kangaroo	kängeruh
karat	karat
karate	karate
kayak	kayak
kebab	kebab
keel	kiel
vigilar/salvar	bewahren
keeps	keeps
recuerdo	andenken
keg	keg
keg	keg
kennel	kennel
kennel	kennel
kerchief	kerchief
kernel	kern
kernel	kern
kernel	kern
kerosene	kerosene
salsa de tomate	ketchup
hervidor	kessel
llave	schlüssel/taste
llave	schlüssel/taste
llave	schlüssel/taste
teclado	tastatur
keyhole	keyhole
keying	keying
keynote	keynote
keypad	keypad
khaki	khaki
patada	stampfen
patada	stampfen
kickback	kickback
kicked	kicked
kicker	kicker
kickoff	kickoff
kicks	kicks
kid	zicklein
kid	zicklein
kid	zicklein
kiddies	kiddies
kiddies	kiddies
kiddies	kiddies
secuestrar	kidnap
kidnaped	kidnaped
kidnaper	kidnaper
kidnaper	kidnaper
kidnapers	kidnapers
kidnaping	kidnaping
kidnapped	kidnapped
kidnapper	kidnapper
kidnappers	kidnappers
kidnapping	kidnapping
kidnappings	kidnappings
riñón	niere
kidneys	kidneys
kidneys	kidneys
kids	kids
kids	kids
matar	ermorden
matar	ermorden
asesino	killer
asesino	killer
killers	killers
killing	killing
killing	killing
killings	killings
killjoy	killjoy
estufa	herd
kilo	kilogramm
kilo	kilogram
kilohertz	kilohertz
kiloliter	kiloliter
kilómetro	kilometer
kilowatt	kilowatt
kilt	kilt
kin	verwand
amable/suerte	freundlich
amable/suerte	freundlich
amable/suerte	freundlich
kindergarten	kindergarten
kindergarten	kindergarten
kindergarten	kindergarten
kindergarten	kindergarten
kindhearted	kindhearted
kindhearted	kindhearted
kindheartedness	kindheartedness
encender	zünden
encender	zünden
kindlessly	kindlessly
kindlessly	kindlessly
kindliness	kindliness
kindliness	kindliness
kindly	kindly
kindly	kindly
kindly	kindly
kindly	kindly
kindness	freundlichkeit
kindness	freundlichkeit
kindred	kindred
kindred	kindred
kinds	freundlicher
kinds	freundlicher
rey	könig
reino	königreich
reino	königreich
kingdoms	kingdoms
kingfisher	eisvogel
kingly	kingly
kings	kings
kinky	kinky
kiosk	kiosk
kipper	kipper
beso	küssen
beso	küssen
beso	küssen
beso	küssen
kisses	kisses
kisses	kisses
kit	bausatz
kit	bausatz
cocina	küche
kitchenette	kitchenette
kitchens	kitchens
kitchenware	kitchenware
kitchenware	kitchenware
cometa	drachen
kith	kith
kiting	kiting
kitten	kätzchen
kittens	kittens
kitty	kitty
kiwi	kiwi
kiwi	kiwi
kleenex	kleenex
kleenex	kleenex
kleptomania	kleptomania
kleptomaniac	kleptomaniac
knack	knack
knack	knack
mochila	tornister
knead	kneten
kneadable	kneadable
kneader	kneader
rodilla	knie
kneecap	kneecap
kneel	kneel
kneel	kneel
kneeling	kneeling
kneeling	kneeling
kneepad	kneepad
knelt	knelt
knelt	knelt
knickers	knickers
knickknack	knickknack
knickknack	knickknack
cuchillo	messer
cuchillo	messer
knifes	knifes
knifing	knifing
caballo	kämpe
caballo	kämpe
knighted	knighted
knighthood	knighthood
knightly	knightly
knights	knights
knit	stricken
knit	stricken
knit	stricken
knitted	knitted
knitting	knitting
knitwear	knitwear
knives	knives
knob	gefäß
knob	gefäß
knobby	knobby
knobs	knobs
knock	klopfen
knockdown	knockdown
knockout	knockout
nudo	knoten
knots	knots
knotted	knotted
knotty	knotty
saber	kennen
knower	knower
knowhow	knowhow
knowhow	knowhow
knowing	weiss
knowingly	knowingly
knowingly	knowingly
conocimiento	begriff
conocimiento	begriff
knowledgeable	kundig
known	known
knows	weisst
nudillo	knuckle
nudillo	knuckle
knucklebone	knucklebone
knuckles	knuckles
koala	koala
koala	koala
kosher	kosher
kraut	kraut
kraut	kraut
krauts	krauts
kudzu	kudzu
lab	lab
labor	arbeiten
trabajador	arbeiter
trabajador	arbeiter
laborers	laborers
encaje	spitze
laceration	laceration
lacerations	lacerations
falta	fehlen
lackadaisical	lackadaisical
lackey	bedienter
lacking	lacking
lackluster	lackluster
laconic	laconic
laconically	laconically
lacquer	firnissen
lacquer	firnissen
lad	junge
damas	damen
dama	dame
ladybird	ladybird
ladybug	marienkäfer
lago	see
lakes	lakes
carne de cordero	lamm
lambs	lambs
laminated	laminated
laminates	laminates
lámpara	lampe
lengua/idioma	sprache
reír	lachen
duro/cuero	ledern
dejar/abandonar	abreisen
lectern	pult
lecture	vortrag
lecturer	lektor
ledge	regal
ledger	ledger
lee	lee
pierna	bein
legal	legal
legality	legality
legalize	legalize
legally	legally
legate	legate
legation	legation
leyende	legende
legendary	legendary
legion	legion
carta	epistel
carta	epistel
carta	epistel
aceptar/como	achten
vivir	hausen
amar/querer/amor	gern haben
amar/querer/amor	gern haben
amante/querido	freier
suerte	glück
almuerzo/almorzar	lunch
ma	mutti
ma	mutti
maam	maam
maam	maam
maam	maam
macabre	macabre
macabre	macabre
macabrely	macabrely
macadam	macadam
macadam	macadam
macadamize	macadamize
macadamize	macadamize
macadamized	macadamized
macadamized	macadamized
macadamizes	macadamizes
macadamizes	macadamizes
macadamizing	macadamizing
macaque	macaque
macaque	macaque
macarrones	makkaroni
macaronies	macaronies
macaroon	macaroon
macaw	macaw
mace	mace
macerate	macerate
macerated	macerated
maceration	maceration
macerations	macerations
maces	maces
machete	machete
machination	machination
machined	machined
machineries	machineries
machinery	maschinerie
machines	machines
machinist	machinist
machinists	machinists
machismo	machismo
macho	macho
macrocephalic	macrocephalic
macrocosm	macrocosm
macroeconomics	macroeconomics
macroevolution	macroevolution
macroevolutionary	macroevolutionary
macroinstruction	macroinstruction
macromolecular	macromolecular
macromolecule	macromolecule
macromolecules	macromolecules
macropathological	macropathological
macropathology	macropathology
macrophage	macrophage
macrophages	macrophages
macrophagic	macrophagic
macroprocessor	macroprocessor
macroscopic	macroscopic
macrosimulation	macrosimulation
macrostructure	macrostructure
maculate	maculate
maculated	maculated
maculates	maculates
maculation	maculation
maculations	maculations
loco	irre
loco	irre
señora	frau
madams	madams
maddened	maddened
made	made
made	made
mademoiselle	mademoiselle
mademoiselles	mademoiselles
maestro	meister
mafioso	mafioso
periódico/revista	zeitung
magic	magie
mago	zauberer
magicians	magicians
magistral	magistral
magistrally	magistrally
magistrature	magistrature
magma	magma
yo	mir
mead	mead
prado	anger
prado	anger
meadowland	meadowland
meadows	meadows
miserable/pobre	mager
meagerly	meagerly
meagre	meagre
harina/comida	mehl
meals	meals
significar	beabsichtigen
meander	sich schlängeln
meaningless	meaningless
meanings	bedeutung
instrumento/medio	bedeutet
carne	fleisch
meats	meats
meatball	meatball
meatballs	meatballs
mechanical	mechaniker
mechanician	mechanician
mechanism	mechanism
mechanisms	mechanisms
medal	denkmünze
medallion	medallion
medallions	medallions
mediatrice	mediatrice
mediatrix	mediatrix
medic	medic
medical	medizinisch
medically	medically
medicament	medicament
medicaments	medicaments
medicinal	medicinal
medicina	medizin
medicines	medicines
medico	medico
medicolegal	medicolegal
medics	medics
medieval	medieval
medievalist	medievalist
medievalists	medievalists
mediocre	mediocre
mediocrity	mediocrity
meditate	erwägen
meditates	meditates
meditation	meditation
meditations	meditations
meditative	meditative
mediano	mittels
medlar	medlar
medley	medley
medleys	medleys
medulla	medulla
medusae	medusae
meek	meek
meekly	meekly
meekness	meekness
meerschaum	meerschaum
megabyte	megabyte
megabytes	megabytes
megacycle	megacycle
megahercio	megahertz
megalith	megalith
megalithic	megalithic
megalomania	megalomania
megalomaniac	megalomaniac
megalomaniacal	megalomaniacal
megaphone	megaphone
melancholia	melancholia
melancholic	melancholic
melange	melange
melodic	melodic
melodies	melodies
melodious	melodious
melodrama	melodram
melodramas	melodramas
melodramatic	melodramatic
melody	melodie
melón	melone
melons	melons
melted	melted
miembro	anhänger
members	members
membrane	membrane
membranes	membranes
membranous	membranous
memoir	memoir
memoirs	memoirs
memorable	memorable
memories	memories
memorize	memorize
memorized	memorized
caballeros	männer
amenaza	bevorstehen
menagerie	menagerie
menageries	menageries
menhir	menhir
meningitis	meningitis
meniscus	meniscus
menopause	menopause
menstrual	menstrual
menstruation	menstruation
menstruations	menstruations
mental	mental
mentality	mentality
menthol	menthol
mencionar	nennen
menú/lista	menü
meow	meow
meowing	meowing
meows	meows
mephitic	mephitic
mercantile	mercantile
mercantilism	mercantilism
mercenaries	mercenaries
mercenary	mercenary
comerciante	händler
merchants	merchants
mercury	quecksilber
misericordia	barmherzigkeit
meridian	meridian
meridional	meridional
merit	verdienen
meritocracy	meritocracy
merits	merits
sirena	die meerjungfrau
mermaids	mermaids
merry	wohlgemut
mensaje	auskunft
mensajes	mitteilungen
messiahs	messiahs
messianic	messianic
moan	ächzen
moaned	moaned
moaning	moaning
moans	moans
moat	moat
moats	moats
mob	mob
mock	äffen
mocked	mocked
mockery	spott
modal	modal
moonlight	mondschein
moose	elch
naive	naiv
naively	naively
desnudo	bloß
nombre	name
named	named
anónimo	nameless
namely	zwar
namely	zwar
names	names
nacional	national
nationalism	nationalism
nationalist	nationalist
innato/indígena	angeboren
fine	natürlich
naturalize	naturalize
naturalmente	natürlich
neap	neap
próximo/cerca	beiläufig
nearer	näher
neglect	unterlassen
vecino	nachbar
vecinos	neighbors
red	garn
networked	networked
networks	netzwerk
nueve	neun
diez y nueve	neunzehn
nineteenth	nineteenth
nineties	nineties
ninetieth	ninetieth
noventa	neunzig
ninetyfold	ninetyfold
ninth	ninth
niobium	niobium
aperitivo	nip
nipple	zitze
nipples	nipples
nips	nips
nirvana	nirvana
nitrate	nitrate
nitrated	nitrated
nitrates	nitrates
nitrating	nitrating
nitration	nitration
nitrations	nitrations
nitric	nitric
nitride	nitride
nitrogen	stickstoff
nitroglycerin	nitroglycerin
nitroglycerine	nitroglycerine
level	edel
nobleman	adeliger
noblemen	noblemen
nobleness	edelmut
nadie/ninguno	keine
noctambulism	noctambulism
noctambulist	noctambulist
nocturn	nocturn
nocturnally	nocturnally
actualmente/ahora	nu
hoy en día	heutzutage
noway	noway
noway	noway
oaf	oaf
oafishness	oafishness
roble	eiche
remo	ruder
remero	oarsman
oasis	oase
oat	hafer
oath	eid
oatmeal	oatmeal
obdurate	obdurate
obedience	obedience
obedient	folgsam
obelisk	obelisk
obese	fett
obesity	obesity
océano	ozean
uno	ein
naranja	apfelsine
oranges	oranges
orbit	orbit
orbital	orbital
orbits	orbits
orquestra	orchester
orchestral	orchestral
orchestras	orchestras
orchestrated	orchestrated
pedir/pedido/orden	befehlen
ordered	ordered
organism	organismus
organisms	organisms
organist	organist
organists	organists
organization	einrichtung
organizations	organizations
organize	einrichten
organized	organized
organs	organs
orgasmo	orgasm
orgasms	orgasms
orgies	orgies
orgia	orgie
orient	orient
orientable	orientable
orientation	orientation
orientations	orientations
oriented	oriented
orients	orients
orifice	orifice
orifices	orifices
orificial	orificial
descendencia/origen	ursprung
original	ursprünglich
originality	originality
originally	originally
originals	originals
origins	origins
ornamental	ornamental
ornithology	ornithology
orthodox	orthodox
orthodoxes	orthodoxes
orthogonal	orthogonal
paso	schreiten
paso	schreiten
pachyderm	pachyderm
pacífico	stillen
pacifically	pacifically
pacification	pacification
pacifications	pacifications
pacificist	pacificist
pacifier	pacifier
pacifism	pacifism
pacifist	pazifist
pacify	pacify
pacify	pacify
paquete	packen
paquete	packen
packaged	packaged
packaged	packaged
packed	packed
paquete	bündel
packing	packing
pact	pact
pacts	pacts
bloque	block
padding	padding
paddle	paddeln
paddock	paddock
padlock	vorhängeschloss
padlock	vorhängeschloss
padrone	padrone
paella	paella
pagan	pagan
pagans	pagans
pageant	pageant
pageantry	pageantry
paid	paid
cubo	eimer
dolor	schmerz
pained	pained
painful	painful
painful	painful
painfully	painfully
painstaking	painstaking
pintura/pintar	färben
pintura/pintar	färben
pincel	pinsel
pintor	maler
painters	painters
cuadro/pintura	bild
paints	paints
par	paar
pijama	schlafanzug
pal	genosse
pal	genosse
palacio	palast
palatable	palatable
palaver	palaver
pálido	blaß
paleta	palette
pall	pall
pallet	pallet
pallette	pallette
pallor	pallor
palmera	handfläche
palmera	handfläche
palpable	palpable
palpable	palpable
paltry	paltry
folleto	broschüre
cacerola	pan
panacea	panacea
panamá	panama
pancake	fladen
oso panda	der panda
pandemonium	pandemonium
pane	pane
panel	paneel
paneling	paneling
panelling	panelling
pang	pang
panic	panik
panic	panik
panicky	panicky
panorama	panorama
pansy	stiefmütterchen
pant	pant
panther	panther
calzoncillos	unterhose
despensa	speisekammer
pantalones	beinkleid
papa	papa
documento/papel	dokument
folleto	broschüre
parameter	parameter
passer	passer
passion	glut
passionately	passionately
passive	passive
passivity	passivity
password	passwort
passwords	passwords
pasado	vergangenheit
pasta	pasta
pectorals	pectorals
peculiar	befremdend
penitence	penitence
penitences	penitences
penitency	penitency
penitent	penitent
pentadactyl	pentadactyl
pentadactylism	pentadactylism
pi	pi
pianist	pianist
pianistic	pianistic
imagen/pintura	ansicht
pictures	pictures
pastel/torta	pastete
pies	pies
cerdo	schwein
pigeonhole	abteilung
pigment	pigment
pigmentation	pigmentation
pigments	pigments
pigs	pigs
piloto	lotsen
pilots	pilots
pilule	pilule
pino	föhre
ananás/piña	ananas
pineapples	pineapples
pines	pines
rosado	rosa
bolsillo	tasche
pocketbook	brieftasche
pocketbooks	pocketbooks
pockets	pockets
podium	podium
pogrom	pogrom
pogroms	pogroms
pointer	zeiger
pointillism	pointillism
pointillist	pointillist
pointilliste	pointilliste
pointillistic	pointillistic
veneno	vergiften
tóxico	giftig
poisonousness	poisonousness
poisons	poisons
polar	polar
polarities	polarities
polarity	polarity
polarize	polarize
polarized	polarized
polemical	polemical
polemically	polemically
polemicize	polemicize
policía	polizei
guardia	polizist
guardia	polizist
guardia	polizist
policemen	policemen
policemen	policemen
policemen	policemen
policewoman	policewoman
policewomen	policewomen
póliza/política	polize
polaco/polonés	polnisch
polaco/polonés	polnisch
cortés	artig
politely	politely
cortesía	politeness
political	politisch
politically	politically
político/hombre político	politician
politicians	politicians
política	politik
polka	polka
pollutant	pollutant
pollute	pollute
polluted	polluted
polluter	polluter
contaminacion	pollution
polonium	polonium
poltergeist	poltergeist
polyandrous	polyandrous
polyandry	polyandry
verter	gießen
pout	schmollen
pobreza	armut
polvos	pudern
powdery	powdery
potencia	gewalt
powerful	gewältig
powerless	powerless
powwow	powwow
practicability	practicability
practicable/transitable	gangbar
practical	praktisch
rezar	beten
oracion	gebet
prayers	prayers
praying	praying
praying	praying
preach	predigen
preach	predigen
preacher	preacher
preacher	preacher
preachers	preachers
preachers	preachers
preaches	preaches
preaches	preaches
preachify	preachify
preaching	preaching
preaching	preaching
preaching	preaching
preachy	preachy
preachy	preachy
preamplifiers	preamplifiers
prearrange	prearrange
prearrange	prearrange
príncipe	fürst
princedom	princedom
princely	princely
princes	princes
princesa	fürstin
principal	hauptsächlich
principal	hauptsächlich
principalities	principalities
principality	fürstentum
principalmente	besonders
principalmente	besonders
principals	principals
principio	grundsatz
principles	principles
imprimir/copiar	drucken
imprimir/copiar	drucken
imprimir/copiar	drucken
printed	ausgedruckt
impresora	drucker
impresora	drucker
priorities	priorities
priorities	priorities
priority	priorität
probar	begründen
pulso	puls
pulverizable	pulverizable
pulverizables	pulverizables
pulverization	pulverization
pulverize	mahlen
pulverized	pulverized
pulverizer	pulverizer
pulverizers	pulverizers
pulverizes	pulverizes
pulverizing	pulverizing
puma	puma
bomba	pumpen
empujar	dringen
pushchair	pushchair
pushing	pushing
meter/poner	legen
putdown	putdown
putout	putout
putrefaction	putrefaction
quail	wachtel
quails	quails
quake	quake
calidad/ralea	art
qualm	qualm
qualms	qualms
cantidad	menge
quarrel	disput
quarry	quarry
barrio	quartier
quarterdeck	quarterdeck
quarterfinal	quarterfinal
reina	königin
queer	wunderlich
quell	erdrosseln
quench	quench
querulous	querulous
query	anfrage
quest	nachsuchung
pregunta	frage
queue	queue
quibble	schikanieren
rápido	geschwind
quicklime	quicklime
pronto	flugs
arenas movedizas	quicksand
quicksilver	quecksilber
quieto/silencio	fromm
quieten	quieten
quietly	quietly
quill	quill
quilt	steppen
quirk	quirk
dimitir	abdanken
muy	sehr
prorrata	quote
cita/citación	zitat
citar/anotar	anführen
r	r
rabbet	rabbet
rabi	rabbiner
rabbinic	rabbinic
conejo	kaninchen
rabbits	rabbits
rabble	gesindel
rabid	rabid
rabies	tollwut
raccoon	raccoon
correr/raza	abkunft
racehorse	racehorse
racemic	racemic
racer	racer
races	races
rachis	rachis
rachitic	rachitic
rachitis	rachitis
racialism	racialism
racialist	racialist
racialistic	racialistic
racing	racing
racism	racism
racist	racist
rack	arrak
raqueta	schläger
raqueta	schläger
radar	radar
radars	radars
radio	radio
leer	lesen
readability	lesbarkeit
readable	readable
reader	reader
readers	readers
readership	readership
readership	readership
readily	gern
readily	gern
readily	gern
readiness	readiness
readiness	readiness
reading	lesung
reading	lesung
reading	lesung
readings	readings
readings	readings
readjust	readjust
readjusts	readjusts
readjusts	readjusts
readout	readout
readout	readout
readouts	readouts
reads	reads
listo	bereit
listo	bereit
listo	bereit
reaffirm	reaffirm
reaffirm	reaffirm
reaffirms	reaffirms
reaffirms	reaffirms
reagent	reagent
real	effektiv
real	effektiv
real	effektiv
realisable	realisable
realism	realism
realist	realist
realistic	realistic
realistic	realistic
realistically	realistically
verdad	wahrheit
comprender/entender	begreifen
en efecto/realmente	tatsächlich
reportero	reporter
reproducir/retratar	abbilden
demanda	bitten
demanda	bitten
demanda	bitten
carretera/ruta	bahn
roads	roads
roadwork	roadwork
robber	freibeuter
rotting	rotting
sabbat	sabbat
sabbath	sabbat
sabbatic	sabbatic
sabbatical	sabbatical
saber	saber
sabin	sabin
sable	sable
sabot	sabot
sabotage	sabotage
sabotaged	sabotaged
sabotages	sabotages
saboteur	saboteur
sabra	sabra
sabras	sabras
saccade	saccade
saccharin	saccharin
saccharine	saccharine
saccharose	saccharose
sacerdotal	sacerdotal
sacerdotally	sacerdotally
sachet	sachet
despedir/bolso	abdanken
despedir/bolso	abdanken
sackcloth	sackcloth
sacked	sacked
sackful	sackful
sacks	sacks
sacrament	sakrament
sacramental	sacramental
sacraments	sacraments
sacre	sacre
sacred	heilig
ofrecer/presentar	erbieten
sacrificed	sacrificed
sacrifices	sacrifices
sacrilege	sakrilegium
triste	düster
acongojar	sadden
sadder	sadder
saddest	saddest
saddle	sattel
saddlebag	saddlebag
saddlebags	saddlebags
saddlebow	saddlebow
saddlecloth	saddlecloth
saddled	saddled
saddleless	saddleless
saddler	saddler
saddlery	saddlery
saddles	saddles
saddletree	saddletree
sadism	sadism
sadist	sadist
sadistic	sadistic
sadistically	sadistically
sadists	sadists
sadly	sadly
tristeza	betrübnis
safari	safari
seguro	sicher
safecracker	safecracker
safecracking	safecracking
safeguard	safeguard
safeguarded	safeguarded
safeguards	safeguards
safer	safer
safest	safest
seguridad	sicherheit
safflower	safflower
saffron	saffron
sag	sag
saga	saga
sagacious	einsichtsvoll
sagaciously	sagaciously
sagaciousness	sagaciousness
sagacity	sagacity
salvia	salbei
sagely	sagely
sago	sago
saguaro	saguaro
sahib	sahib
said	sagte
sail	segel
sail	segel
sailable	sailable
bote de vela	das segelboat
sailboater	sailboater
sailcloth	sailcloth
sailors	sailors
sails	sails
sainfoin	sainfoin
santa/santo	heiliger
sainted	sainted
sainthood	sainthood
saith	saith
sake	sake
salability	salability
salacious	salacious
ensalada	salat
salads	salads
salamandra	der salamander
salaried	salaried
salaries	salaries
venta	absatz
saleable	saleable
saleroom	saleroom
salesclerk	salesclerk
salesgirl	salesgirl
saleslady	saleslady
vendedor	ladengehilfe
salesmanship	salesmanship
salesmen	verkäufer
salespeople	salespeople
salesperson	salesperson
salesroom	salesroom
vendedora	ladenfräulein
saleswomen	saleswomen
salient	salient
saline	saline
salinity	salinity
salinometer	salinometer
salinometers	salinometers
saliva	speichel
salivary	salivary
salivate	salivate
salivated	salivated
salivates	salivates
salivating	salivating
salivation	salivation
sallies	sallies
pálido	blaß
sallowish	sallowish
salmón	lachs
salmons	salmons
salon	aula
salons	salons
sal	salzen
saltwater	saltwater
saltworks	saltworks
saltwort	saltwort
salty	salzen
salubrious	bekömmlich
salubrity	salubrity
salvage	heil
salver	salver
samba	samba
misma	gleiche
sampan	sampan
samphire	samphire
samurai	samurai
samurais	samurais
arena	sand
sandalia	sandale
escuela	schule
36586	meer
vender	veräußern
seller	seller
sellers	sellers
serendipity	serendipity
serene	heiter
siete	sieben
sevenfold	sevenfold
diez y siete	siebzehn
seventeenth	seventeenth
seventh	seventh
seventies	seventies
seventieth	seventieth
setenta	siebzig
seventyfold	seventyfold
sever	sever
áspero/inclemente	streng
severed	severed
severely	severely
severities	severities
severity	severity
sewage	sewage
sexo	geschlecht
sexagenarian	sexagenarian
sexual	generisch
sexually	sexually
shades	shades
sombra	schatten
shadows	shadows
shagreen	shagreen
shah	schah
agitar	erschüttern
shakedown	shakedown
shaken	shaken
shaky	shaky
shaman	shaman
shamanism	shamanism
champú	shampoo
shampoos	shampoos
oveja	hammel
sheepherder	sheepherder
expedir/barco	abfertigen
expedir/barco	abfertigen
mierda	mist
enfermo	krank
plata	silber
cantar	singen
cantora	berufssänger
bucear	tauchen
seis	sechs
diez y seis	sechzehn
sixteenth	sixteenth
sixties	sixties
sesenta	sechzig
sixtyfold	sixtyfold
tamaño	ausdehnung
patinar	rochen
skateboard	skateboard
skateboarder	skateboarder
skateboarding	skateboarding
skateboards	skateboards
skater	skater
skaters	skaters
skates	skates
skating	skating
skill	geschicklichkeit
experto/hábil	geübt
skilless	skilless
experto/hábil	geübt
cielo	himmel
skylark	lerche
skyscraper	skyscraper
snout	snout
nieve	schneien
snowball	snowball
copo de nieve	schneeflocke
snowman	snowman
snowstorm	snowstorm
software	software
sorrily	sorrily
tristeza	betrübnis
suerte	abart
sorted	sorted
sorter	sorter
alma	gemüt
spectra	spectra
spectrum	spectrum
speculate	speculate
speculation	speculation
grapa	klammer
stapled	stapled
engrapador	die heftmaschine
staplers	staplers
staples	staples
estrella	stern
stars	stars
salida/salir	anstellen
stifled	stifled
fuerza	stärke
zote	blödsinnig
asignatura	subjekt
conseguir	erfolg haben
acierto	erfolg
sol	sonne
sunbathe	sunbathe
sunny	sonnig
suppressed	suppressed
suspect	argwöhnen
swear	lästern
tab	tab
tab	tab
tabernacle	tabernacle
mesa/tabla	tabelle
tableau	tableau
tableaus	tableaus
tableaux	tableaux
mantel	tischtucher
tablecloths	tablecloths
tablas	tables
pastilla	tabelle
tablets	tablets
taboos	taboos
tachometer	tachometer
tachometers	tachometers
tacit	tacit
cola	sterz
costurera/sastre	schneidern
tailored	tailored
tailors	tailors
tails	frack
task	arbeit
tasks	angaben
gusto/saborear	schmecken
tasted	tasted
soso	fade
lágrima	zerreißen
lágrima	zerreißen
lágrima	zerreißen
lágrima	zerreißen
teardrop	teardrop
tearful	tearful
tearfully	tearfully
tearfully	tearfully
teargas	teargas
tearjerker	tearjerker
tearless	tearless
tearless	tearless
tearoom	tearoom
tears	tränen
tears	tränen
tearstained	tearstained
tearstained	tearstained
zumbon	tease
zumbon	tease
zumbon	tease
teasel	teasel
teaser	teaser
teaser	teaser
teases	teases
teases	teases
teases	teases
teasing	teasing
teasing	teasing
teasingly	teasingly
teasingly	teasingly
cucharita	teaspoon
cucharita	teaspoon
cucharadita	teaspoonful
teat	brust
teat	brust
teat	brust
teat	brust
teatime	teatime
teats	teats
teats	teats
diez	zehn
tendencies	tendencies
tentación	stimmung
tenderfoot	tenderfoot
tenderly	zärtlich
thence	daher
thence	daher
thenceforth	thenceforth
thenceforward	thenceforward
theocracy	theocracy
theocratic	theocratic
theodolite	theodolite
theologian	theologe
theologians	theologians
theological	theological
theologically	theologically
theology	theologie
theorem	theorem
theorems	theorems
theoretical	theoretical
theoretical	theoretical
theoretically	theoretically
theoretician	theoretician
theoretician	theoretician
theoreticians	theoreticians
theoreticians	theoreticians
theorist	theorist
theorist	theorist
theorists	theorists
theorists	theorists
theorize	theorize
ladrón	dieb
aunque	obgleich
aunque	obgleich
pensamiento	gedanke
pensamiento	gedanke
circunspecto/prudente	thoughtful
thoughtfully	thoughtfully
thoughtfulness	vorsorge
thoughtless	thoughtless
thoughtlessly	thoughtlessly
thoughtlessness	thoughtlessness
mil	tausend
thousandth	thousandth
aporrear	verhauen
aporrear	verhauen
hilo	faden
hilo	faden
hilo	faden
threadbare	threadbare
amenaza/conminación	bedrohung
amenazar/conminar	bevorstehen
threatening	threatening
threateningly	threateningly
tres	drei
tigress	tigress
hoy	heute
dedo de pie	zehe
tradicion	tradition
traditional	traditionell
trail	geleise
adiestrar/tren	abrichten
trainee	trainee
trainer	trainer
traitor	traitor
transaction	transaction
transalpine	transalpine
transcribir	transcribe
atravesar	entern
traducir	übersetzen
traducción	übersetzung
translator	übersetzer
despachar	schicken
árbol	baum
camión	lastauto
dos	zwei
ubiquitous	ubiquitous
ubiquity	ubiquity
udder	euter
ugh	ugh
uglier	uglier
ugliest	ugliest
uglify	uglify
uglily	uglily
ugliness	ugliness
feo	häßlich
ukulele	ukulele
úlcera	geschwür
ulcerate	ulcerate
ulcerated	ulcerated
ulceration	ulceration
ulcerative	ulcerative
ulna	ulna
ultimo	ultimo
unemployment	arbeitlosigkeit
vacant	vacant
vacate	vacate
vacaciones	ferien
vacunar	impfen
vaccinated	vaccinated
aspirador	vacuum
vacuumed	vacuumed
vagina	vagina
vagrant	vagrant
vague	vague
vanidoso	vergebens
wacky	wacky
wag	wag
walnut	walnuß
warehouse	geschäft
warehouse	geschäft
warehouses	warehouses
lavar	spülen
llorar	tränen
weeping	weeping
weeping	weeping
weeps	weeps
weepy	weepy
weepy	weepy
weevil	weevil
weft	weft
pesar	wägen
pesar	wägen
weighing	weighing
weighings	weighings
weighs	weighs
peso	gewicht
weighted	weighted
weighted	weighted
weightily	weightily
weighting	weighting
weighting	weighting
weightless	weightless
weightlessness	gewichtslosigkeit
weights	weights
weights	weights
weighty	schwer
weighty	schwer
weir	weir
weird	seltsam
weirdie	weirdie
weirdies	weirdies
weirdly	weirdly
weirdness	weirdness
weirdness	weirdness
weirdo	weirdo
weirdos	weirdos
weirs	weirs
bienvenido	willkommen
bienvenido	willkommen
bienvenido	willkommen
bienvenido	willkommen
adonde	war
ventana/taquilla	fenster
ventana/taquilla	fenster
windowpane	windowpane
windowpanes	windowpanes
windows	windows
windstorm	windstorm
vino	wein
wineglass	wineglass
winegrower	winegrower
winemaker	winemaker
winemaking	winemaking
winepress	winepress
wines	wines
winey	winey
ala	fittich
winglet	winglet
wink	zwinkern
invierno	winter
enjugar/limpiar	wischen
alambre	draht
alambre	draht
alambre	draht
wired	wired
radio	radio
wiring	wiring
wiry	wiry
sabiduria	weisheit
sabio	gescheit
wisecrack	wisecrack
wisely	wisely
wiser	wiser
desear/deseo	wünschen
desear/deseo	wünschen
wishbone	wishbone
wishes	wünsche
wishful	wishful
witch	hexe
witches	witches
con	mit
retirar	zurückziehen
retirar	zurückziehen
sin	ohne
testigo	zeuge
testigo	zeuge
witnesses	witnesses
wolverine	wolverine
wolverine	wolverine
mundo	welt
worldwide	universal
xenophobe	xenophobe
xenophobia	xenophobia
xenophobic	xenophobic
xerographic	xerographic
xylem	xylem
xylene	xylene
xylophone	xylophone
xylophones	xylophones
xylophonist	xylophonist
xylose	xylose
xylotomic	xylotomic
yate	jacht
yachting	yachting
yachtsman	yachtsman
yak	yak
yam	yamswurzel
yap	yap
grave/patio	hof
yardstick	yardstick
yarn	yarn
bostezar	gähnen
bostezar	gähnen
yawning	yawning
yeah	ja
año	jahr
yearbook	yearbook
yearlong	yearlong
anualmente	jährlich
anualmente	jährlich
yearn	sich ersehnen
yearning	yearning
yearningly	yearningly
anos	jahr
yeast	yeast
yell	heulen
yell	heulen
amarillo	gelb
yellowed	yellowed
yellowing	yellowing
yellowish	yellowish
sí	ja
ayer	gestern
aún/todavia	noch
yew	yew
abandonar/ceder	abtreten
yoga	yoga
yogur	yoghurt
yogur	yogurt
yugo	joch
yolk	yolk
tú/usted	du/sie
tú/usted	du/sie
joven	jung
younger	jüngere
joven	jüngling
juventud/joven	jugend
youthful	youthful
yuppie	yuppie
zabaglione	zabaglione
zany	zany
zazen	zazen
celo	eifer
zealous	eifrig
cebra	zebra
zenith	zenit
cero	null
cero	null
zest	zest
zigzag	im zickzack gehen
zinc	zink
cremallera	reissverschluss
zodiaco	tierkreis
zodiaco	tierkreis
zona	zone
zona	zone
jardín zoológico	zoo
zoologia	zoologie
zoom	zoom
calabacín	zucchini
