un/una	à
un/una	à
aardvark	aardvark
aardvark	aardvark
aardvarks	aardvarks
hacia atrás	aback
hacia atrás	aback
hacia atrás	aback
abacterial	abacterial
ábaco	abaque
ábaco	abaque
ábaco	abaque
abacuses	abacuses
abacuses	abacuses
abacuses	abacuses
abaft	abaft
abalone	abalone
abalones	abalones
abandonar	abandonner
abandonar	abandonner
abandoned	immoral
abandoned	immoral
abandoned	immoral
abandonee	abandonee
abandoner	abandoner
abandoning	abandoning
abandono	abandonment
abandono	abandonment
abandonments	abandonments
rebajar	humilier
abased	abased
abasement	abasement
abasements	abasements
abases	abases
confundir	abash
abashed	abashed
abashed	abashed
abasing	abasing
disminuir/decrecer	diminuer
disminuir/decrecer	diminuer
abated	abated
reducción	rabais
reducción	rabais
abatements	abatements
abates	abates
abating	abating
abating	abating
carnicería	boucherie
abbe	abbe
abberations	abberations
abadía	abbaye
abadía	abbaye
abbeys	abbeys
abad	abbé
abad	abbé
abad	abbé
abad	abbé
abad	abbé
abbots	abbots
abreviar	raccourcir
abreviar	raccourcir
abbreviated	abbreviated
abbreviates	abbreviates
abbreviating	abbreviating
abreviación	abbreviation
abreviación	abbreviation
abreviación	abbreviation
abbreviations	abbreviations
abbreviations	abbreviations
abbreviator	abbreviator
abdicable	abdicable
abdicar	abdiquer
abdicar	abdiquer
abdicated	abdicated
abdicación	abdication
abdicator	abdicator
abdomen	abdomen
abdomen	abdomen
abdomens	abdomens
abdominal	abdominal
abdominally	abdominally
abducir	abduct
abducted	abducted
abducting	abducting
secuestro	abduction
abductions	abductions
secuestrador	abducteur
abductors	abductors
abeam	abeam
abecedarian	abecedarian
abed	abed
desvío	aberrance
aberrante	aberrant
aberrantly	aberrantly
aberración	erreur
aberración	erreur
aberrations	aberrations
instigar	agiter
abetment	abetment
abets	abets
abetted	abetted
abetter	abetter
abetting	abetting
abettor	abettor
suspensión	abeyance
abeyant	abeyant
aborrecer	abominer
abhorred	abhorred
horror	abomination
horrible	abominable
abhorrently	abhorrently
abhorring	abhorring
abhors	abhors
aguardar	attendre
abided	abided
abides	abides
continuo	permanent
abilities	abilities
capacidad	capacité
capacidad	capacité
abiotic	abiotic
miserable/pobre	lâche
abjection	abjection
abjectly	abjectly
abjuration	abjuration
abjurar	abjurer
abjurer	abjurer
ablation	ablation
ablative	ablatif
ablaze	ardant
ablaze	ardant
capaz/hábil	apte à
capaz/hábil	apte à
capaz/hábil	apte à
capaz/hábil	apte à
abler	abler
ablest	ablest
abloom	abloom
ablution	ablution
ablutions	ablutions
hábilmente	ably
abnegate	agir avec abnégation
abnegates	abnegates
abnegation	abnegation
anormal	abnormal
anormal	abnormal
anormal	abnormal
abnormalities	abnormalities
anormalidad	abnormality
irregularmente	abnormally
a bordo	aboard
abode	domicile
abodes	abodes
aboil	aboil
abolir	abolir
abolir	abolir
abolishable	abolishable
abolished	abolished
abolisher	abolisher
abolishes	abolishes
supresión	abolishment
abolición	abolition
abolición	abolition
abolitionism	abolitionism
abolitionist	abolitionist
abolitionists	abolitionists
abominable	abominable
abominably	abominably
abominar	abominer
aversión/horror	abomination
abominations	abominations
indígena	aborigène
aboriginally	aboriginally
aborigine	aborigine
aborigines	aborigines
abortar	avorter
aborted	aborted
aborter	aborter
aborting	aborting
aborto	avortement
aborto	avortement
abortionist	avorteur
abortionists	abortionists
abortions	abortions
abortivo	inutile
abortively	abortively
aborts	aborts
abundar	abonder
cerca	concernant
encima de	au-dessus de
aboveboard	aboveboard
aboveground	aboveground
abovementioned	abovementioned
abovementioned	abovementioned
abracadabra	abracadabra
abradable	abradable
abrade	abrade
abrasion	abrasion
abrasions	abrasions
afilado	acéré
abrasives	abrasives
abreast	abreast
abreviar	limiter
abridged	abridged
resumen	réduction de texte
abridging	abridging
en el extranjero	à l'étranger
abrogar	abolir
abrogated	abrogated
abolición	abolition
escarpado	abrupt
abruptamente	abruptement
abruptness	abruptness
absceso	abcès
abscesses	abscesses
abscond	s'enfuir
absconded	absconded
ausencia/falta	absence
absences	absences
ausente	absent
ausente	absentee
absenteeism	absenteeism
absentees	absentees
absently	absently
absentminded	absentminded
absentmindedly	absentmindedly
absentmindedly	absentmindedly
absentmindedness	absentmindedness
absinth	absinthe
absinthe	absinthe
absoluto	absolu
absolutamente	absolument
absolution	absolution
absolutism	absolutisme
absolver	absoudre
absolved	absolved
absolving	absolving
abssorber	absorber
absorbability	absorbability
absorbable	absorbable
absorbant	absorbant
absorbed	absorbed
absorbent	absorbant
absorbing	absorbing
absorption	absorption
abstenerse	faire abstinence
abstained	abstained
abstemious	sobre
abstention	abstention
abstentions	abstentions
abstinence	abstinence
abstinent	abstinent
abstinently	abstinently
decudir	abstrait
decudir	abstrait
robo	abstraction
abstruse	mystérieux
absurd	absurde
absurdism	absurdism
absurdist	absurdist
absurdities	absurdities
absurdity	absurdité
riqueza	abondance
abundante	abondant
abundantly	abondamment
ofender	insulter
abused	abused
abusive	abusive
abusively	abusively
abut	abut
abuzz	abuzz
abysmal	terrible
abysmally	abysmally
abismo	abîme
abismo	abîme
abysses	abysses
abysses	abysses
acacia	acacia
estudiante	académique
academical	academical
academically	academically
academician	académicien
academies	academies
academism	academism
academia	académie
acanthus	acanthe
acanthuses	acanthuses
acordar	adhérer
acordar	adhérer
acelerar	accélerer
accelerated	accelerated
acceleration	accélération
accelerations	accelerations
acelerador	accélérateur
accelerators	accelerators
accelerometer	accelerometer
accelerometers	accelerometers
acento	accentuer
accented	accented
accented	accented
accents	accents
accentual	accentual
accentually	accentually
acentuar	accentuer
accentuated	accentuated
accentuation	accentuation
aceptar	accepter
aceptabilidad	acceptability
aceptable	acceptable
acceptably	acceptably
aceptación	accueil
accepted	accepté
accepter	accepter
acceptor	accepteur
acometida	accès
accessed	accessed
accessibility	accessibility
alcanzable	sensible
adquisición	acquisition
accessorial	accessorial
accessories	accessories
accessorize	accessorize
accessors	accessors
apéndice	accessoire
accidente	accident
accidental	accidental
accidentalism	accidentalism
accidentalist	accidentalist
accidentally	accidentally
accidently	accidently
accidents	accidents
aplaudir	acclamer
aplauso	acclamation
acclimate	acclimate
acclimated	acclimated
aclimatar	acclimatize
accolade	accolade
accolades	accolades
acomodar	adapter
accommodated	accommodated
oficioso/servicial	accommodating
acuerdo	accomodation
accommodations	accommodations
accompanied	accompanied
accompanier	accompanier
accompanies	accompanies
accompaniment	accompagnement
accompaniments	accompaniments
accompanist	cavalier
accompanists	accompanists
acompañar	accompagner
accompanyist	accompanyist
accompanyists	accompanyists
accomplice	accomplice
accomplices	accomplices
realizar	atteindre
accomplished	accomplished
accomplishment	accomplishment
accomplishments	accomplishments
acorde	accord
accordance	accordance
accorder	accorder
accorders	accorders
acordeón	accordéon
accordionist	accordéoniste
accordionists	accordionists
accordions	accordions
accords	accords
accost	accost
cuenta	compte
accountability	accountability
accountable	accountable
contador público	accountant
accounting	accounting
accouterment	accouterment
accrued	accrued
accruement	accruement
accumulated	accumulated
acetaminophen	acetaminophen
acetify	acetify
acetone	acetone
agrio	acide
acidic	acidic
allergen	allergen
allergen	allergen
allergic	allergic
allergies	allergies
allergies	allergies
alergia	allergy
alergia	allergy
alleviate	alleviate
alleviated	alleviated
calleja	ruelle
calleja	ruelle
alleys	alleys
alleys	alleys
alliance	alliance
alliance	alliance
alliances	alliances
alliances	alliances
allied	allied
allied	allied
alligator	alligator
alligator	alligator
alligators	alligators
alligators	alligators
alliteration	alliteration
alliteration	alliteration
alliterations	alliterations
alliterations	alliterations
allocate	allocate
allocated	allocated
allocation	allocation
allocation	allocation
allocations	allocations
allocution	allocution
allocution	allocution
allocution	allocution
allot	allot
permitir	laisser
allowable	allowable
allowance	allowance
allowed	allowed
alloy	alliage
alfabeto	alphabet
alphabetic	alphabetic
alphabetical	alphabetical
alphabetization	alphabetization
alphabetizations	alphabetizations
alfabetizar	alphabetize
alphabetized	alphabetized
alphabetizing	alphabetizing
alphabets	alphabets
alphamerical	alphamerical
alphanumeric	alphanumeric
alphanumerical	alphanumerical
alphanumerically	alphanumerically
alphanumerics	alphanumerics
alpine	alpine
alpinism	alpinism
alpinist	alpinist
ya	déjà
también	aussi
altercation	altercation
altercations	altercations
alternar	alterner
alternated	alternated
alternately	alternately
entre	entre
amoral	amoral
amorous	amorous
amorously	amorously
amorphous	amorphous
número/suma	nombre
número/suma	nombre
amp	amp
ampere	ampere
ampersand	ampersand
amphetamine	amphetamine
y	et
anyway	anyway
anywhere	quelque part
aorta	aorta
apace	apace
aparte	particulier
apartheid	apartheid
apartamento	appartement
apathetic	apathetic
apathy	apathie
mono	singe
mono	singe
aperitif	aperitif
abetura	orifice
apex	apex
aphid	aphid
llegar	arriver
aspen	aspen
controlar	vérifier
aula magna	auditorium
auditoriums	auditoriums
audits	audits
disponible	available
babble	babble
babbler	babbler
babies	babies
baboon	babouin
bebé	bébé
baccalaureate	baccalaureate
baccarat	baccarat
solterón	célibataire
bachelors	bachelors
bacilli	bacilli
bacillus	bacillus
reverso	dos
backache	backache
backbite	backbite
backbone	backbone
fondo	arrière-plan
backgrounds	backgrounds
backside	derrière
backslide	backslide
backup	backup
atrasado	backward
tocino	lard
bacteria	bacteria
malo	mal
badge	insigne
badged	badged
badgers	badgers
badinage	badinage
bolso	bag
bagatelle	bagatelle
bagatelles	bagatelles
equipaje/equipajes	colis
bags	bags
baguette	baguette
bah	bah
bail	bail
carnada/cebo	bait
bake	faire cuire au four
panadero	boulanger
bakeries	bakeries
bakers	bakers
panadería	boulangerie
bakeshop	bakeshop
balance	reliquat
balconies	balconies
balcón	balcon
bald	chauve
baldhead	baldhead
baldly	baldly
baldness	baldness
bale	bale
baleen	baleen
balk	balk
pelota	bal
ballad	ballad
ballade	ballade
ballads	ballads
lastre	ballast
ballet	ballet
balletic	balletic
globo	aérostat
balotaje	ballot
balls	balls
ballyhoo	ballyhoo
bálsamo	beaume
bambú	bamboo
bamboozle	bamboozle
plátano	banane
bananas	bananas
tira	bande
vendaje	bandage
bandeau	bandeau
bandido	bandit
bandits	bandits
bandleader	bandleader
bandmaster	bandmaster
bane	bane
banished	banished
barb	barb
bárbaro	barbarian
barbarians	barbarians
barbarism	barbarism
barbero	coiffeur
barmaid	barmaid
barman	barman
cuartel	caserne
playa	plage
parir/oso	faire naître
parir/oso	faire naître
cauce	planche
bedroom	chambre à coucher
creer	croire
betray	trahir
bibliographic	bibliographic
bibliographies	bibliographies
bibliography	bibliography
zarzamora	blackberry
libro	livre
boomerang	boomerang
boxeador	boxer
chico/muchacho	garçon
boys	boys
cerebro	cerveau
brood	brood
escoba	balai
broth	broth
construir	construire
construcción	construction
adiós	adieu
cabriolé	cab
cabal	cabal
cabala	cabala
cabalism	cabalism
cabalist	cabalist
cabalistic	cabalistic
caballero	caballero
cabarét	cabaret
col	chou
cabbages	cabbages
cabdriver	cabdriver
cabana	cabane
armario	armoire
cabinetmaker	cabinetmaker
cabinetmakers	cabinetmakers
cabinets	cabinets
cabins	cabins
cable	câble
cabled	cabled
cablegram	cablegram
cablegrams	cablegrams
cables	cables
cabling	cabling
cabman	cabman
caboose	caboose
cabotage	cabotage
cabriolet	cabriolet
cabs	cabs
cacao	cacao
cacciatore	cacciatore
cachalot	cachalot
cache	cache
cachepot	cachepot
caches	caches
cackle	cackle
cackled	cackled
cackles	cackles
cackling	cackling
cacophony	cacophony
cacti	cacti
cacto	cactus
cad	cad
cadaver	cadavre
cadaverous	cadaverous
caddies	caddies
caddy	caddy
cadence	cadence
cadet	cadet
cadetship	cadetship
cadge	cadge
cadger	cadger
cafe	cafe
cafes	cafes
cafeteria	cafeteria
cafeterias	cafeterias
caffeine	caffeine
caftan	caftan
cage	cage
cages	cages
cahier	cahier
cairn	cairn
cairns	cairns
caitiff	caitiff
cajole	cajole
cajoler	cajoler
cajolery	cajolery
queque	gâteau
queque	gâteau
calcium	calcium
calcular	calculer
calculated	calculated
calibrate	calibrate
calibrated	calibrated
calibration	calibration
automóvil/coche	auto
carbonization	carbonization
carbonize	carbonize
carbonized	carbonized
carbonless	carbonless
carburetor	carburetor
carburetors	carburetors
carburization	carburization
carburize	carburize
carda	carte
cardamom	cardamom
cardiac	cordial
cardigan	cardigan
cardioid	cardioid
cardioids	cardioids
cuidar/cuidado	avoir soin de
cuidar/cuidado	avoir soin de
cared	cared
carrera	career
circunspecto/prudente	prudent
carefully	carefully
gato	mégère
célula	cachot
cellular	cellular
probabilidad/oportunidad	hasard
cerezas	cherries
iglesia	église
churches	churches
capa	manteau
cloaks	cloaks
reloj	horloge
clockmaker	clockmaker
clockwise	clockwise
cloister	cloister
clone	clone
nube	nuage
clouds	clouds
carbon	charbon
computador	ordinateur
ordenadores	computers
comrades	comrades
concealed	concealed
conjuring	conjuring
contemplate	contempler
contemplate	contempler
contemplate	contempler
contemplates	contemplates
contemplation	contemplation
contemplation	contemplation
contemplation	contemplation
contemplations	contemplations
contemplations	contemplations
contemplative	contemplative
contemporaneous	contemporaneous
contemporaneously	contemporaneously
contemporaries	contemporaries
contemporaries	contemporaries
contemporary	contemporary
contemporary	contemporary
desprecio	contempt
desprecio	contempt
contemptible	contemptible
contemptibly	contemptibly
contemptuous	contemptuous
contemptuous	contemptuous
contemptuously	contemptuously
contemptuously	contemptuously
contend	contend
contend	contend
contend	contend
contender	contender
contender	contender
contender	contender
contenders	contenders
contenders	contenders
contenders	contenders
contending	contending
contending	contending
contends	contends
contends	contends
content	content
content	content
content	content
contento	content
contento	content
contentedly	contentedly
contentedness	contentedness
contention	contention
contention	contention
contention	contention
contentions	contentions
contentions	contentions
contentions	contentions
contentious	contentious
contentious	contentious
contentment	contentment
contents	contenu
contents	contenu
concurso	concours
concurso	concours
concurso	concours
contestant	contestant
contestant	contestant
camita de niño	cot
trinquete	coterie
cotillion	cotillion
cotillon	cotillon
cottage	cottage
cottager	cottager
canapé	canapé
toser	tousser
coughs	coughs
calcular/computar	comte
countenance	countenance
counteract	counteract
counterbalance	counterbalance
anular/contramandar	countermand
countermarch	countermarch
counterplot	counterplot
counterpoint	counterpoint
counterpoise	counterpoise
counterweight	counterweight
countess	countess
countless	countless
campo/país	campagne
countryman	paysan
countrywide	countrywide
county	county
embragar	couple
couplet	couplet
cupón	coupon
valor	courage
courageous	courageux
courageously	courageously
mensajero	courier
cursillo/curso/plato	piste
courser	courser
grave/patio	cour
cortés	courtois
courteously	courteously
courteousness	courteousness
courtesy	courtesy
courthouse	courthouse
courtier	courtier
courtliness	courtliness
courtly	courtly
courtmartial	courtmartial
courtroom	courtroom
courtship	courtship
prima/primo	cousine
cove	cove
covenant	covenant
cubrir	couvrir
covert	covert
covet	covet
covetous	covetous
covetously	covetously
vaca	vache
vaca	vache
coward	peureux
cowardice	faiblesse
cowardly	cowardly
cower	être accroupi
cowherd	cowherd
cowl	cowl
coxcomb	coxcomb
coy	coy
coyly	coyly
coyness	coyness
coyote	coyote
cozily	cozily
cozy	cozy
crabapple	crabapple
crabbed	crabbed
hendedura	craquer
cracker	cracker
crackle	crackle
cradle	cradle
astucia	craft
craftily	craftily
crag	crag
cram	cram
cramp	cramp
cranberry	cranberry
grúa	grue
cranium	cranium
crankiness	crankiness
cranky	cranky
crape	crape
choque	crash
crate	crate
crater	crater
crave	crave
craven	craven
crawl	ramper
cangrejo	écrevisse
crayon	crayon
craze	craze
crazily	crazily
crazy	fou
creak	grincer
crema/desnatar	crème
creamy	creamy
crease	froisser
cree	créer
creacion	creation
creator	creator
creature	créature
credence	credence
credential	lettre de créance
haber	credit
creditable	creditable
creditably	creditably
creditor	creditor
credo	credo
credulity	credulity
credulous	credulous
credulously	credulously
creed	creed
creek	creek
creep	ramper
creeps	creeps
cremate	cremate
cortar	faucher
cute	cute
cute	cute
cuteness	cuteness
cutoffs	cutoffs
cutout	cutout
corta	cuts
cutter	cutter
cutting	cutting
cyanate	cyanate
cyanide	cyanide
cybernetic	cybernetic
cybernetician	cybernetician
cybernetics	cybernetics
bicicleta/ciclo	bécane
cyclic	cyclic
cyclical	cyclical
cyclist	cyclist
cyclists	cyclists
cycloid	cycloid
cycloidal	cycloidal
ciclón	cyclone
cyclonic	cyclonic
cyclopean	cyclopean
cyclotron	cyclotron
cilindro	cylindre
papa	papa
daddies	daddies
papa	papa
dads	dads
daffy	daffy
daft	daft
daga	dagger
dahlia	dahlia
dahlias	dahlias
todos los días/a diario	journalier
daintier	daintier
amable/fino	aimable
lechería	dairy
dalmatian	dalmate
dalmatians	dalmatians
obstrucción/presa	dam
daño	endommager
daño	endommager
daño	endommager
daño	endommager
estropeado	damaged
estropeado	damaged
damager	damager
damagers	damagers
damages	damages
damaging	damaging
dame	dame
dammit	dammit
damnation	damnation
damned	damned
humedo	damp
dampen	dampen
dampened	dampened
dampness	dampness
dams	dams
bailar/baile	bal
dancer	dancer
dancers	dancers
dancing	dancing
dandelion	pissenlit
dandelions	dandelions
dandies	dandies
caspa	dandruff
peligro	danger
peligroso	dangereux
dardo	dart
día	jour
amanecer	point du jour
daylight	daylight
días	days
deactivate	deactivate
deactivation	deactivation
muerto	dead
sordo	sourd
deaths	deaths
profundo	profond
density	density
deserve	mériter
detat	detat
detre	detre
aparato	appareil
aparato	appareil
dictated	dictated
dictates	dictates
dictation	dictation
dictations	dictations
dictionaries	dictionaries
diccionario	dictionnaire
did	did
morir	décéder
died	died
diesel	diesel
dieta	diète
dietetically	dietetically
diets	diets
diferente/disferente	différent
difficulties	difficulties
inconveniente	difficulty
cavar	creuser
digested	digested
dignitaries	dignitaries
dignities	dignities
dignity	dignité
dilate	dilate
dilated	dilated
doctor/médico	docteur
doeuvre	doeuvre
perro	chien
doggie	doggie
perros	dogs
bebida/beber	s'enivrer
drinks	drinks
propulsión	amener à
drizzle	drizzle
seco/árido	sec
pato	canard
cada	chaque
águila	aigle
eagles	eagles
eaglet	eaglet
oreja	oreille
earache	earache
eardrum	eardrum
eardrums	eardrums
earlobe	earlobe
temprano	hâtif
ganar	gagner
earning	earning
earphones	earphones
earring	earring
arete	earrings
ears	ears
tierra	butter
terremoto	earthquake
earthquakes	earthquakes
earths	earths
earthworm	earthworm
earthworms	earthworms
earwax	earwax
ease	ease
caballete	établi
easier	easier
easiest	easiest
fácilmente	facilement
easiness	easiness
este	est
pascua	pâques
fácil	facile
comer	déjeuner
eatable	eatable
eats	eats
ebony	ebony
eccentric	eccentric
eccentricity	eccentricity
ecclesiastic	ecclesiastic
echo	écho
eclipse	eclipse
ecologic	ecologic
ecologist	ecologist
ecology	ecology
economics	economics
ecru	ecru
ocho	huit
dieciocho/diez y ocho	dix-huit
decimooctavo	eighteenth
eightfold	eightfold
octavo	eighth
eighties	eighties
eightieth	eightieth
ochenta	eighty
eightyfold	eightyfold
einsteinium	einsteinium
either	either
ejaculate	ejaculate
ejaculated	ejaculated
ejaculates	ejaculates
ejaculating	ejaculating
ejaculation	ejaculation
ejaculations	ejaculations
ejaculatory	ejaculatory
eject	eject
ejectable	ejectable
ejecting	ejecting
ejection	ejection
ejector	ejector
ejectors	ejectors
trabajado	elaborate
elaborated	elaborated
elaborates	elaborates
elaborating	elaborating
elaboration	elaboration
elaborations	elaborations
ascensor	ascenseur
once	onze
eleventh	eleventh
eliminate	eliminate
terminar/fin	cesser
alrededores	milieu
embajador	envoy
envidiar	envier
envidiar	envier
escalator	escalator
edificar	fonder
acontecimiento	événement
eventual	éventuel
eventually	eventually
ever	jadis
evergreen	evergreen
everlasting	infini
cada	every
en todas partes	partout
eviction	eviction
evidence	evidence
exclaim	exclaim
fable	fable
fables	fables
tela	fabric
fabricant	fabricant
fabricar	fabriquer
fabricated	fabricated
fabricates	fabricates
fabricating	fabricating
fabrication	fabrication
fabrications	fabrications
fabricator	fabricator
fabricators	fabricators
fabrics	fabrics
fabulist	fabulist
fabulous	fabulous
frontón	façade
facades	facades
faceless	faceless
faceplate	faceplate
facet	facet
facetious	facetious
facetious	facetious
facetiously	facetiously
facial	facial
facies	facies
fácil	facile
facilitate	faciliter
facilitated	facilitated
facilitates	facilitates
facilitating	facilitating
facilities	facilities
facility	facility
facing	facing
facsimile	facsimile
hecho	fact
partido	parti
factor	factor
factorial	factorial
factorials	factorials
factories	factories
factorization	factorization
factorizations	factorizations
factorize	factorize
factorized	factorized
factors	factors
fábrica	usine
facts	facts
factual	factual
facultative	facultative
facultatively	facultatively
faculties	faculties
faculty	faculté
fad	fad
fade	pâlir
faded	faded
fader	fader
faders	faders
fading	fading
faery	faery
faience	faience
faltar	fail
débil/desmayarse	faible
faintly	faintly
bazar/pasable	foire
fairly	relativement
fairy	fée
faithful	fidèle
faithfully	faithfully
fashionable	actuel
rápido/pronto	jeûner
fastener	fastener
fastidious	fastidious
grueso/gordo	épais
fatal	fatal
fatalism	fatalism
fatality	fatality
fatally	fatally
destino	destination
pez	pêcher
fishable	fishable
fishbowl	fishbowl
fished	fished
fisher	fisher
fisheries	fisheries
pescador	pêcheur
fishermen	fishermen
fishers	fishers
fishery	fishery
fishes	fishes
pesca	fishing
fishtail	fishtail
atomización	fission
fissionable	fissionable
fissure	fissure
puño	poing
fisted	fisted
fistful	fistful
cinco	cinq
fivefold	fivefold
fijar/reparar	déterminer
fixation	fixation
fixations	fixations
fixity	fixity
fixture	fixture
fixtures	fixtures
fjord	fiord
fjords	fjords
vuelo	fuite
flexible	floppy
fluently	fluently
pie	patte
fútbol americano	foot
olvidar	oublier
forgetful	forgetful
forgetfulness	forgetfulness
forgivable	forgivable
forgivably	forgivably
perdonar	excuser
forgiveness	forgiveness
forgives	forgives
forgiving	forgiving
forgo	forgo
forgoes	forgoes
forgotten	forgotten
forlorn	forlorn
formaldehyde	formaldehyde
cuatro	quatre
zorro	renard
fractal	fractal
fractals	fractals
fraction	fraction
fractionate	fractionate
fraternal	fraternal
fraternize	fraternize
amigo	amie
amistad	amitié
fringe	fringe
rana	grenouille
frogs	frogs
de/desde	de
frontón	front
fucked	fucked
fudge	fudge
fugue	fugue
fulgurant	fulgurant
funk	peureux
funniest	funniest
cómico	amusant
gab	gab
gabardine	gabardine
gabber	gabber
gabbing	gabbing
gaberdine	gaberdine
gadget	gadget
gaiety	gaiety
gaily	gaily
ganar/provecho	acquisition
gained	gained
gaining	gaining
gala	gala
galactic	galactic
galaxy	galaxy
gallant	brave
gallantly	gallantly
gallantry	gallantry
galleries	galleries
gallery	galerie
gallon	gallon
gallop	gallop
galloped	galloped
galloping	galloping
galvanic	galvanic
galvanism	galvanism
galvanize	galvanize
galvanized	galvanized
juego/partido	jeu
juegos	games
ajo	ail
gas	gaz
bencina/gasolina	essence
ghostwriter	ghostwriter
regalo	don
regalos	gifts
ir/dirigirse	aller
fin/objeto	but
goals	goals
cabra	chèvre
dios	dieu
goddess	goddess
goddesses	goddesses
godfather	parrain
golf	golfe
golfer	golfer
golfers	golfers
golfs	golfs
bueno	bon
bueno	bon
adiós	adieu
goodnight	goodnight
gopher	gopher
vestido	robe
asir/coger	saisir
gradient	gradient
poco a poco	de proche en proche
gramática	grammaire
uva	raisin
pomelo	pamplemousse
habilitated	habilitated
habilitation	habilitation
costumbre/hábito	coutume
habitant	habitant
habitants	habitants
habitat	habitat
habitation	habitation
habitual	habitual
had	had
trabajador/mano	ouvrier
cabeza/efigie	guider
heats	heats
cielo	ciel
pesado	lourd
hectare	hectare
hectares	hectares
hectoliter	hectoliter
hedgehog	hedgehog
acatar	heed
talón/tacón	talon
heeler	heeler
heels	heels
altura/altitud	altitude
held	held
helices	helices
hell	hell
hola	hello
timón/volante	gouvernail
casco	helmet
ayuda/ayudar	aider
hemp	hemp
gallina	poulet
herd	troupeau
aquí/en ésta	ici
heron	héron
hips	hips
pegar a	battre
hockey sobre hielo	hockey
hogwash	hogwash
holidayer	holidayer
holidays	holidays
hogar	domicile
homeless	homeless
homes	homes
casa	maison
hielo	crème glacée
instancing	instancing
internship	internship
jab	jab
jabber	jabber
jabberwocky	jabberwocky
jabberwocky	jabberwocky
gato	bambin
jackal	jackal
jackals	jackals
jackass	jackass
jackdaw	jackdaw
chaqueta	veste
chaqueta	veste
jackknife	jackknife
jackpot	jackpot
cansar/fatigar	jade
jaded	jaded
jag	jag
jagged	jagged
prisión	prison
prisión	prison
jailbreak	jailbreak
jailed	jailed
jailer	jailer
jailing	jailing
jailor	jailor
jails	jails
jalopy	jalopy
mermelada	confiture
mermelada	confiture
jamb	jamb
jammed	jammed
jammed	jammed
jangle	jangle
portero	janitor
portero	janitor
jar	jar
jar	jar
jar	jar
jargon	jargon
jasmine	jasmine
jaundice	jaundice
jaunt	jaunt
jaunty	jaunty
javelin	javelin
mandíbula	mâchoire
jaws	gouffre
jay	jay
jazz	jazz
jazzy	jazzy
celoso	jaloux
jealousy	envie
injuriar/insultar	jeer
injuriar/insultar	jeer
jelly	jelly
medusa	jellyfish
jeopardize	jeopardize
jeopardize	jeopardize
jerk	jerk
jerk	jerk
jerry	jerry
jersey	jersey
jersey	jersey
bromear	plaisanter
jester	jester
jester	jester
jet	jet
jet	jet
jettison	jettison
jetty	jetty
joya	bijou
jeweler	jeweler
jewelery	jewelery
jewelry	jewelry
jewels	jewels
jib	jib
jib	jib
jiffy	jiffy
jig	jig
jigsaw	jigsaw
jihad	jihad
jilt	jilt
jingle	tinter
jingle	tinter
jingle	tinter
jinx	jinx
jitters	jitters
trabajo	ouvrage
trabajo	ouvrage
trabajo	ouvrage
jobless	jobless
jockey	jockey
jocular	jocular
jocund	jocund
jodhpur	jodhpur
jog	jog
correr	jogging
reunirse/juntarse	adhérer
reunirse/juntarse	adhérer
joinable	joinable
joined	joined
joiner	joiner
joinery	joinery
común	articulation
común	articulation
común	articulation
jointly	jointly
broma/chanza	plaisanter
broma/chanza	plaisanter
joked	joked
joker	joker
jokingly	jokingly
jokingly	jokingly
jolly	jolly
jolt	jolt
jolt	jolt
jonquils	jonquils
jostle	jostle
jot	jot
jot	jot
journal	journal
journal	journal
journalism	journalism
periodista	journaliste
journalists	journalists
viaje	voyage
viaje	voyage
jovial	jovial
jovially	jovially
alegría	joie
joyful	joyful
joyless	joyless
joyously	joyously
jubilee	jubilee
juez/juzgar	juger
juez/juzgar	juger
judged	judged
sentencia	arrêt
judicial	judicial
judiciary	judiciary
judo	judo
jarra	cruche
jarra	cruche
jarra	cruche
juggernaut	juggernaut
juggle	jongler
juggler	juggler
jugular	jugular
jugo/zumo	jus
juiceless	juiceless
juicier	juicier
juiciest	juiciest
jugosos	juicy
jukebox	jukebox
jumble	jumble
jumbo	jumbo
saltar/salto	sauter
jumped	jumped
jumpy	jumpy
unión/reunión	junction
unión/reunión	junction
jungla	jungle
junior	junior
juniper	juniper
junk	junk
junk	junk
junk	junk
junk	junk
junkers	junkers
junkers	junkers
junkie	junkie
junkie	junkie
junkyard	junkyard
juridic	juridic
jurisdiction	jurisdiction
jurist	jurist
juror	juror
jurors	jurors
jurado	jury
sólo/solamente	juste
justicia	justice
justified	justified
justify	justify
justly	justly
jut	jut
juvenile	juvenile
juxtapose	juxtapose
kale	kale
kaleidescope	kaleidescope
kaleidoscope	kaleidoscope
kangaroo	kangaroo
karat	karat
karate	karate
kayak	kayak
kebab	kebab
keel	keel
vigilar/salvar	continuer
keeps	keeps
recuerdo	souvenir
keg	keg
keg	keg
kennel	kennel
kennel	kennel
kerchief	kerchief
kernel	centre
kernel	centre
kernel	centre
kerosene	kerosene
salsa de tomate	ketchup
hervidor	chaudron
llave	touche
llave	touche
llave	touche
teclado	keyboard
keyhole	keyhole
keying	keying
keynote	keynote
keypad	keypad
khaki	khaki
patada	kick
patada	kick
kickback	kickback
kicked	kicked
kicker	kicker
kickoff	kickoff
kicks	kicks
kid	kid
kid	kid
kid	kid
kiddies	kiddies
kiddies	kiddies
kiddies	kiddies
secuestrar	kidnap
kidnaped	kidnaped
kidnaper	kidnaper
kidnaper	kidnaper
kidnapers	kidnapers
kidnaping	kidnaping
kidnapped	kidnapped
kidnapper	kidnapper
kidnappers	kidnappers
kidnapping	kidnapping
kidnappings	kidnappings
riñón	rein
kidneys	kidneys
kidneys	kidneys
kids	kids
kids	kids
matar	rectifier
matar	rectifier
asesino	killer
asesino	killer
killers	killers
killing	killing
killing	killing
killings	killings
killjoy	killjoy
estufa	cuisinière
kilo	kilogramme
kilo	kilogram
kilohertz	kilohertz
kiloliter	kiloliter
kilómetro	kilomètre
kilowatt	kilowatt
kilt	kilt
kin	kin
amable/suerte	affable
amable/suerte	affable
amable/suerte	affable
kindergarten	kindergarten
kindergarten	kindergarten
kindergarten	kindergarten
kindergarten	kindergarten
kindhearted	kindhearted
kindhearted	kindhearted
kindheartedness	kindheartedness
encender	allumer
encender	allumer
kindlessly	kindlessly
kindlessly	kindlessly
kindliness	kindliness
kindliness	kindliness
kindly	kindly
kindly	kindly
kindly	kindly
kindly	kindly
kindness	amabilité
kindness	amabilité
kindred	kindred
kindred	kindred
kinds	kinds
kinds	kinds
rey	roi
reino	royaume
reino	royaume
kingdoms	kingdoms
kingfisher	martin-pêcheur
kingly	kingly
kings	kings
kinky	kinky
kiosk	kiosk
kipper	kipper
beso	embrasser
beso	embrasser
beso	embrasser
beso	embrasser
kisses	kisses
kisses	kisses
kit	kit
kit	kit
cocina	cuisine
kitchenette	kitchenette
kitchens	kitchens
kitchenware	kitchenware
kitchenware	kitchenware
cometa	kite
kith	kith
kiting	kiting
kitten	kitten
kittens	kittens
kitty	kitty
kiwi	kiwi
kiwi	kiwi
kleenex	kleenex
kleenex	kleenex
kleptomania	kleptomania
kleptomaniac	kleptomaniac
knack	knack
knack	knack
mochila	sac tyrolien
knead	pétrir
kneadable	kneadable
kneader	kneader
rodilla	genou
kneecap	kneecap
kneel	s'agenouiller
kneel	s'agenouiller
kneeling	kneeling
kneeling	kneeling
kneepad	kneepad
knelt	knelt
knelt	knelt
knickers	knickers
knickknack	knickknack
knickknack	knickknack
cuchillo	couteau
cuchillo	couteau
knifes	knifes
knifing	knifing
caballo	chevalier
caballo	chevalier
knighted	knighted
knighthood	knighthood
knightly	knightly
knights	knights
knit	tricoter
knit	tricoter
knit	tricoter
knitted	knitted
knitting	knitting
knitwear	knitwear
knives	knives
knob	knob
knob	knob
knobby	knobby
knobs	knobs
knock	frapper
knockdown	knockdown
knockout	knockout
nudo	nouer
knots	knots
knotted	knotted
knotty	knotty
saber	connaître
knower	knower
knowhow	knowhow
knowhow	knowhow
knowing	knowing
knowingly	knowingly
knowingly	knowingly
conocimiento	connaissance
conocimiento	connaissance
knowledgeable	knowledgeable
known	known
knows	knows
nudillo	knuckle
nudillo	knuckle
knucklebone	knucklebone
knuckles	knuckles
koala	koala
koala	koala
kosher	kosher
kraut	kraut
kraut	kraut
krauts	krauts
kudzu	kudzu
lab	lab
labor	labor
trabajador	ouvrier
trabajador	ouvrier
laborers	laborers
encaje	dentelle
laceration	laceration
lacerations	lacerations
falta	défaut
lackadaisical	lackadaisical
lackey	lackey
lacking	lacking
lackluster	lackluster
laconic	laconic
laconically	laconically
lacquer	lacquer
lacquer	lacquer
lad	lad
damas	ladies
dama	dame
ladybird	ladybird
ladybug	ladybug
lago	lac
lakes	lakes
carne de cordero	agneau
lambs	lambs
laminated	laminated
laminates	laminates
lámpara	lampe
lengua/idioma	langue
reír	rire
duro/cuero	cuir
dejar/abandonar	partir
lectern	pupitre
lecture	conférence
lecturer	lecturer
ledge	ledge
ledger	ledger
lee	lee
pierna	jambe
legal	légitime
legality	legality
legalize	legalize
legally	legally
legate	legate
legation	legation
leyende	legend
legendary	legendary
legion	legion
carta	lettre
carta	lettre
carta	lettre
aceptar/como	comme
vivir	demeurer
amar/querer/amor	aimer
amar/querer/amor	aimer
amante/querido	amante
suerte	destinée
almuerzo/almorzar	lunch
ma	ma
ma	ma
maam	maam
maam	maam
maam	maam
macabre	macabre
macabre	macabre
macabrely	macabrely
macadam	macadam
macadam	macadam
macadamize	macadamize
macadamize	macadamize
macadamized	macadamized
macadamized	macadamized
macadamizes	macadamizes
macadamizes	macadamizes
macadamizing	macadamizing
macaque	macaque
macaque	macaque
macarrones	macaroni
macaronies	macaronies
macaroon	macaroon
macaw	macaw
mace	mace
macerate	macerate
macerated	macerated
maceration	maceration
macerations	macerations
maces	maces
machete	machete
machination	machination
machined	machined
machineries	machineries
machinery	machinery
machines	machines
machinist	machinist
machinists	machinists
machismo	machismo
macho	macho
macrocephalic	macrocephalic
macrocosm	macrocosm
macroeconomics	macroeconomics
macroevolution	macroevolution
macroevolutionary	macroevolutionary
macroinstruction	macroinstruction
macromolecular	macromolecular
macromolecule	macromolecule
macromolecules	macromolecules
macropathological	macropathological
macropathology	macropathology
macrophage	macrophage
macrophages	macrophages
macrophagic	macrophagic
macroprocessor	macroprocessor
macroscopic	macroscopic
macrosimulation	macrosimulation
macrostructure	macrostructure
maculate	maculate
maculated	maculated
maculates	maculates
maculation	maculation
maculations	maculations
loco	fou
loco	fou
señora	madame
madams	madams
maddened	maddened
made	made
made	made
mademoiselle	mademoiselle
mademoiselles	mademoiselles
maestro	maestro
mafioso	mafioso
periódico/revista	gazette
magic	magie
mago	magician
magicians	magicians
magistral	magistral
magistrally	magistrally
magistrature	magistrature
magma	magma
yo	me
mead	mead
prado	prairie
prado	prairie
meadowland	meadowland
meadows	meadows
miserable/pobre	maigre
meagerly	meagerly
meagre	meagre
harina/comida	farine
meals	meals
significar	moyenne
meander	meander
meaningless	meaningless
meanings	meanings
instrumento/medio	instrument
carne	viande
meats	meats
meatball	meatball
meatballs	meatballs
mechanical	mechanical
mechanician	mechanician
mechanism	mechanism
mechanisms	mechanisms
medal	médaille
medallion	medallion
medallions	medallions
mediatrice	mediatrice
mediatrix	mediatrix
medic	medic
medical	medical
medically	medically
medicament	medicament
medicaments	medicaments
medicinal	medicinal
medicina	remède
medicines	medicines
medico	medico
medicolegal	medicolegal
medics	medics
medieval	medieval
medievalist	medievalist
medievalists	medievalists
mediocre	mediocre
mediocrity	mediocrity
meditate	méditer
meditates	meditates
meditation	meditation
meditations	meditations
meditative	meditative
mediano	medium
medlar	medlar
medley	medley
medleys	medleys
medulla	medulla
medusae	medusae
meek	meek
meekly	meekly
meekness	meekness
meerschaum	meerschaum
megabyte	megabyte
megabytes	megabytes
megacycle	megacycle
megahercio	megahertz
megalith	megalith
megalithic	megalithic
megalomania	megalomania
megalomaniac	megalomaniac
megalomaniacal	megalomaniacal
megaphone	megaphone
melancholia	melancholia
melancholic	melancholic
melange	melange
melodic	melodic
melodies	melodies
melodious	melodious
melodrama	melodrama
melodramas	melodramas
melodramatic	melodramatic
melody	mélodie
melón	melon
melons	melons
melted	melted
miembro	adhérent
members	members
membrane	membrane
membranes	membranes
membranous	membranous
memoir	memoir
memoirs	memoirs
memorable	memorable
memories	memories
memorize	apprendre par cur
memorized	memorized
caballeros	men
amenaza	gronder
menagerie	menagerie
menageries	menageries
menhir	menhir
meningitis	meningitis
meniscus	meniscus
menopause	menopause
menstrual	menstrual
menstruation	menstruation
menstruations	menstruations
mental	intellectuel
mentality	mentality
menthol	menthol
mencionar	mentionner
menú/lista	carte
meow	meow
meowing	meowing
meows	meows
mephitic	mephitic
mercantile	mercantile
mercantilism	mercantilism
mercenaries	mercenaries
mercenary	mercenary
comerciante	commerçant
merchants	merchants
mercury	mercure
misericordia	compassion
meridian	meridian
meridional	meridional
merit	mériter
meritocracy	meritocracy
merits	merits
sirena	mermaid
mermaids	mermaids
merry	gai
mensaje	message
mensajes	messages
messiahs	messiahs
messianic	messianic
moan	gémir
moaned	moaned
moaning	moaning
moans	moans
moat	moat
moats	moats
mob	mob
mock	se moquer
mocked	mocked
mockery	simulacre
modal	modal
moonlight	moonlight
moose	élan
naive	naïf
naively	naively
desnudo	nu
nombre	nom
named	named
anónimo	nameless
namely	namely
namely	namely
names	names
nacional	national
nationalism	nationalism
nationalist	nationalist
innato/indígena	inné
fine	naturel
naturalize	naturalize
naturalmente	bien sûr
neap	neap
próximo/cerca	près
nearer	nearer
neglect	dédaigner
vecino	voisin
vecinos	neighbors
red	filet
networked	networked
networks	networks
nueve	neuf
diez y nueve	dix-neuf
nineteenth	nineteenth
nineties	nineties
ninetieth	ninetieth
noventa	ninety
ninetyfold	ninetyfold
ninth	ninth
niobium	niobium
aperitivo	nip
nipple	mamelon
nipples	nipples
nips	nips
nirvana	nirvana
nitrate	nitrate
nitrated	nitrated
nitrates	nitrates
nitrating	nitrating
nitration	nitration
nitrations	nitrations
nitric	nitric
nitride	nitride
nitrogen	azote
nitroglycerin	nitroglycerin
nitroglycerine	nitroglycerine
level	élevé
nobleman	noble
noblemen	noblemen
nobleness	grandeur
nadie/ninguno	nul
noctambulism	noctambulism
noctambulist	noctambulist
nocturn	nocturn
nocturnally	nocturnally
actualmente/ahora	eh bien
hoy en día	actuellement
noway	noway
noway	noway
oaf	oaf
oafishness	oafishness
roble	chêne
remo	rame
remero	oarsman
oasis	oasis
oat	oat
oath	serment
oatmeal	oatmeal
obdurate	obdurate
obedience	obedience
obedient	docile
obelisk	obelisk
obese	obese
obesity	obesity
océano	océan
uno	on
naranja	orange
oranges	oranges
orbit	orbit
orbital	orbital
orbits	orbits
orquestra	orchestre
orchestral	orchestral
orchestras	orchestras
orchestrated	orchestrated
pedir/pedido/orden	commander
ordered	ordered
organism	organism
organisms	organisms
organist	organist
organists	organists
organization	organization
organizations	organizations
organize	organiser
organized	organized
organs	organs
orgasmo	orgasm
orgasms	orgasms
orgies	orgies
orgia	orgie
orient	orient
orientable	orientable
orientation	orientation
orientations	orientations
oriented	oriented
orients	orients
orifice	orifice
orifices	orifices
orificial	orificial
descendencia/origen	origine
original	inédit
originality	originality
originally	originally
originals	originals
origins	origins
ornamental	ornamental
ornithology	ornithology
orthodox	orthodoxe
orthodoxes	orthodoxes
orthogonal	orthogonal
paso	faire les cent pas
paso	faire les cent pas
pachyderm	pachyderm
pacífico	pacifique
pacifically	pacifically
pacification	pacification
pacifications	pacifications
pacificist	pacificist
pacifier	pacifier
pacifism	pacifism
pacifist	pacifist
pacify	pacify
pacify	pacify
paquete	package
paquete	package
packaged	packaged
packaged	packaged
packed	packed
paquete	paquet
packing	packing
pact	pact
pacts	pacts
bloque	bloc
padding	padding
paddle	barbotter
paddock	paddock
padlock	padlock
padlock	padlock
padrone	padrone
paella	paella
pagan	pagan
pagans	pagans
pageant	pageant
pageantry	pageantry
paid	paid
cubo	seau
dolor	douleur
pained	pained
painful	pénible
painful	pénible
painfully	painfully
painstaking	painstaking
pintura/pintar	couleur
pintura/pintar	couleur
pincel	pinceau
pintor	peintre
painters	painters
cuadro/pintura	painting
paints	paints
par	paire
pijama	pajamas
pal	camarade
pal	camarade
palacio	palais
palatable	palatable
palaver	palaver
pálido	pâle
paleta	palette
pall	pall
pallet	pallet
pallette	pallette
pallor	pallor
palmera	paume
palmera	paume
palpable	palpable
palpable	palpable
paltry	paltry
folleto	brochure
cacerola	pan
panacea	panacea
panamá	panama
pancake	pancake
oso panda	panda
pandemonium	pandemonium
pane	pane
panel	lambris
paneling	paneling
panelling	panelling
pang	pang
panic	panique
panic	panique
panicky	panicky
panorama	panorama
pansy	pensée
pant	pant
panther	panthère
calzoncillos	caleçon
despensa	buffet
pantalones	pantalon
papa	papa
documento/papel	document
folleto	brochure
parameter	parameter
passer	passer
passion	ardeur
passionately	passionately
passive	passive
passivity	passivity
password	password
passwords	passwords
pasado	passé
pasta	pasta
pectorals	pectorals
peculiar	drôle
penitence	penitence
penitences	penitences
penitency	penitency
penitent	penitent
pentadactyl	pentadactyl
pentadactylism	pentadactylism
pi	pi
pianist	pianist
pianistic	pianistic
imagen/pintura	image
pictures	pictures
pastel/torta	pâté
pies	pies
cerdo	cochon
pigeonhole	spécialité
pigment	pigment
pigmentation	pigmentation
pigments	pigments
pigs	pigs
piloto	pilote
pilots	pilots
pilule	pilule
pino	pin
ananás/piña	ananas
pineapples	pineapples
pines	pines
rosado	pink
bolsillo	poche
pocketbook	pocketbook
pocketbooks	pocketbooks
pockets	pockets
podium	estrade
pogrom	pogrom
pogroms	pogroms
pointer	pointer
pointillism	pointillism
pointillist	pointillist
pointilliste	pointilliste
pointillistic	pointillistic
veneno	poison
tóxico	poisonous
poisonousness	poisonousness
poisons	poisons
polar	polar
polarities	polarities
polarity	polarity
polarize	polarize
polarized	polarized
polemical	polemical
polemically	polemically
polemicize	polemicize
policía	police
guardia	agent
guardia	agent
guardia	agent
policemen	policemen
policemen	policemen
policemen	policemen
policewoman	policewoman
policewomen	policewomen
póliza/política	politique
polaco/polonés	polonais
polaco/polonés	polonais
cortés	courtois
politely	politely
cortesía	politesse
political	political
politically	politically
político/hombre político	politician
politicians	politicians
política	politique
polka	polka
pollutant	pollutant
pollute	pollute
polluted	polluted
polluter	polluter
contaminacion	pollution
polonium	polonium
poltergeist	poltergeist
polyandrous	polyandrous
polyandry	polyandry
verter	verser
pout	pout
pobreza	poverty
polvos	poudre
powdery	powdery
potencia	puissance
powerful	puissant
powerless	powerless
powwow	powwow
practicability	practicability
practicable/transitable	practicable
practical	réel
rezar	prier
oracion	prière
prayers	prayers
praying	praying
praying	praying
preach	prêcher
preach	prêcher
preacher	preacher
preacher	preacher
preachers	preachers
preachers	preachers
preaches	preaches
preaches	preaches
preachify	preachify
preaching	preaching
preaching	preaching
preaching	preaching
preachy	preachy
preachy	preachy
preamplifiers	preamplifiers
prearrange	prearrange
prearrange	prearrange
príncipe	prince
princedom	princedom
princely	princely
princes	princes
princesa	princesse
principal	principal
principal	principal
principalities	principalities
principality	principality
principalmente	principalement
principalmente	principalement
principals	principals
principio	principe
principles	principles
imprimir/copiar	impression
imprimir/copiar	impression
imprimir/copiar	impression
printed	printed
impresora	imprimeur
impresora	imprimeur
priorities	priorities
priorities	priorities
priority	priority
probar	démontrer
pulso	pouls
pulverizable	pulverizable
pulverizables	pulverizables
pulverization	pulverization
pulverize	moudre
pulverized	pulverized
pulverizer	pulverizer
pulverizers	pulverizers
pulverizes	pulverizes
pulverizing	pulverizing
puma	puma
bomba	pomper
empujar	pousser
pushchair	pushchair
pushing	pushing
meter/poner	appliquer
putdown	putdown
putout	putout
putrefaction	putrefaction
quail	quail
quails	quails
quake	quake
calidad/ralea	propriété
qualm	qualm
qualms	qualms
cantidad	quantité
quarrel	se disputer
quarry	quarry
barrio	quartier
quarterdeck	quarterdeck
quarterfinal	quarterfinal
reina	queen
queer	queer
quell	étouffer
quench	quench
querulous	querulous
query	query
quest	recherche
pregunta	question
queue	queue
quibble	chicaner
rápido	prompt
quicklime	quicklime
pronto	rapidement
arenas movedizas	quicksand
quicksilver	quicksilver
quieto/silencio	calme
quieten	quieten
quietly	paisiblement
quill	quill
quilt	coudre
quirk	quirk
dimitir	démissioner
muy	bien
prorrata	quota
cita/citación	citation
citar/anotar	citer
r	r
rabbet	rabbet
rabi	rabbin
rabbinic	rabbinic
conejo	lapin
rabbits	rabbits
rabble	rabble
rabid	rabid
rabies	rage
raccoon	raton laveur
correr/raza	s'élancer
racehorse	racehorse
racemic	racemic
racer	racer
races	races
rachis	rachis
rachitic	rachitic
rachitis	rachitis
racialism	racialism
racialist	racialist
racialistic	racialistic
racing	racing
racism	racism
racist	racist
rack	rack
raqueta	racket
raqueta	racket
radar	radar
radars	radars
radio	radio
leer	lire
readability	readability
readable	readable
reader	lecteur
readers	readers
readership	readership
readership	readership
readily	readily
readily	readily
readily	readily
readiness	readiness
readiness	readiness
reading	reading
reading	reading
reading	reading
readings	readings
readings	readings
readjust	readjust
readjusts	readjusts
readjusts	readjusts
readout	readout
readout	readout
readouts	readouts
reads	reads
listo	prêt
listo	prêt
listo	prêt
reaffirm	reaffirm
reaffirm	reaffirm
reaffirms	reaffirms
reaffirms	reaffirms
reagent	reagent
real	effectif
real	effectif
real	effectif
realisable	realisable
realism	realism
realist	realist
realistic	realistic
realistic	realistic
realistically	realistically
verdad	réalité
comprender/entender	comprendre
en efecto/realmente	en réalité
reportero	reporter
reproducir/retratar	représenter
demanda	demander
demanda	demander
demanda	demander
carretera/ruta	chemin
roads	roads
roadwork	roadwork
robber	ravisseur
rotting	rotting
sabbat	sabbat
sabbath	sabbath
sabbatic	sabbatic
sabbatical	sabbatical
saber	saber
sabin	sabin
sable	sable
sabot	sabot
sabotage	sabotage
sabotaged	sabotaged
sabotages	sabotages
saboteur	saboteur
sabra	sabra
sabras	sabras
saccade	saccade
saccharin	saccharin
saccharine	saccharine
saccharose	saccharose
sacerdotal	sacerdotal
sacerdotally	sacerdotally
sachet	sachet
despedir/bolso	licencier
despedir/bolso	licencier
sackcloth	sackcloth
sacked	sacked
sackful	sackful
sacks	sacks
sacrament	sacrament
sacramental	sacramental
sacraments	sacraments
sacre	sacre
sacred	sacré
ofrecer/presentar	consacrer
sacrificed	sacrificed
sacrifices	sacrifices
sacrilege	sacrilege
triste	affligé
acongojar	sadden
sadder	sadder
saddest	saddest
saddle	selle
saddlebag	saddlebag
saddlebags	saddlebags
saddlebow	saddlebow
saddlecloth	saddlecloth
saddled	saddled
saddleless	saddleless
saddler	saddler
saddlery	saddlery
saddles	saddles
saddletree	saddletree
sadism	sadism
sadist	sadist
sadistic	sadistic
sadistically	sadistically
sadists	sadists
sadly	sadly
tristeza	affliction
safari	safari
seguro	à l'abri
safecracker	safecracker
safecracking	safecracking
safeguard	safeguard
safeguarded	safeguarded
safeguards	safeguards
safer	safer
safest	safest
seguridad	sécurité
safflower	safflower
saffron	saffron
sag	sag
saga	saga
sagacious	intelligent
sagaciously	sagaciously
sagaciousness	sagaciousness
sagacity	sagacity
salvia	sauge
sagely	sagely
sago	sago
saguaro	saguaro
sahib	sahib
said	said
sail	voile
sail	voile
sailable	sailable
bote de vela	sailboat
sailboater	sailboater
sailcloth	sailcloth
sailors	sailors
sails	sails
sainfoin	sainfoin
santa/santo	saint
sainted	sainted
sainthood	sainthood
saith	saith
sake	sake
salability	salability
salacious	salacious
ensalada	salade
salads	salads
salamandra	salamander
salaried	salaried
salaries	salaries
venta	sale
saleable	saleable
saleroom	saleroom
salesclerk	salesclerk
salesgirl	salesgirl
saleslady	saleslady
vendedor	marchand
salesmanship	salesmanship
salesmen	salesmen
salespeople	salespeople
salesperson	salesperson
salesroom	salesroom
vendedora	saleswoman
saleswomen	saleswomen
salient	salient
saline	saline
salinity	salinity
salinometer	salinometer
salinometers	salinometers
saliva	salive
salivary	salivary
salivate	salivate
salivated	salivated
salivates	salivates
salivating	salivating
salivation	salivation
sallies	sallies
pálido	pâle
sallowish	sallowish
salmón	saumon
salmons	salmons
salon	salon
salons	salons
sal	saler
saltwater	saltwater
saltworks	saltworks
saltwort	saltwort
salty	salty
salubrious	salubrious
salubrity	salubrity
salvage	salut
salver	salver
samba	samba
misma	identique
sampan	sampan
samphire	samphire
samurai	samurai
samurais	samurais
arena	sable
sandalia	sandale
escuela	école
36586	mer
vender	vendre
seller	seller
sellers	sellers
serendipity	serendipity
serene	serein
siete	36770
sevenfold	sevenfold
diez y siete	dix-sept
seventeenth	seventeenth
seventh	seventh
seventies	seventies
seventieth	seventieth
setenta	seventy
seventyfold	seventyfold
sever	sever
áspero/inclemente	sévère
severed	severed
severely	severely
severities	severities
severity	severity
sewage	sewage
sexo	sexe
sexagenarian	sexagenarian
sexual	sexual
sexually	sexually
shades	shades
sombra	ombre
shadows	shadows
shagreen	shagreen
shah	schah
agitar	secouer
shakedown	shakedown
shaken	shaken
shaky	shaky
shaman	shaman
shamanism	shamanism
champú	shampoo
shampoos	shampoos
oveja	mouton
sheepherder	sheepherder
expedir/barco	expédier
expedir/barco	expédier
mierda	shit
enfermo	malade
plata	argent
cantar	chanter
cantora	chanteuse
bucear	forer
seis	six
diez y seis	seize
sixteenth	sixteenth
sixties	sixties
sesenta	soixante
sixtyfold	sixtyfold
tamaño	ampleur
patinar	patin
skateboard	skateboard
skateboarder	skateboarder
skateboarding	skateboarding
skateboards	skateboards
skater	skater
skaters	skaters
skates	skates
skating	skating
skill	adresse
experto/hábil	skilled
skilless	skilless
experto/hábil	adroit
cielo	ciel
skylark	skylark
skyscraper	skyscraper
snout	snout
nieve	neiger
snowball	snowball
copo de nieve	flocon de neige
snowman	snowman
snowstorm	snowstorm
software	software
sorrily	sorrily
tristeza	sorrow
suerte	sorte
sorted	sorted
sorter	sorter
alma	âme
spectra	spectra
spectrum	spectrum
speculate	speculate
speculation	speculation
grapa	parenthèse
stapled	stapled
engrapador	stapler
staplers	staplers
staples	staples
estrella	étoile
stars	stars
salida/salir	activer
stifled	stifled
fuerza	force
zote	sot
asignatura	sujet
conseguir	arriver
acierto	prospérité
sol	soleil
sunbathe	sunbathe
sunny	sunny
suppressed	suppressed
suspect	soupçonner
swear	blasphémer
tab	tab
tab	tab
tabernacle	tabernacle
mesa/tabla	liste
tableau	tableau
tableaus	tableaus
tableaux	tableaux
mantel	tablecloth
tablecloths	tablecloths
tablas	tables
pastilla	liste
tablets	tablets
taboos	taboos
tachometer	tachometer
tachometers	tachometers
tacit	tacit
cola	queue
costurera/sastre	couturière
tailored	tailored
tailors	tailors
tails	habit
task	devoir
tasks	tasks
gusto/saborear	goût
tasted	tasted
soso	tasteless
lágrima	larme
lágrima	larme
lágrima	larme
lágrima	larme
teardrop	teardrop
tearful	tearful
tearfully	tearfully
tearfully	tearfully
teargas	teargas
tearjerker	tearjerker
tearless	tearless
tearless	tearless
tearoom	tearoom
tears	tears
tears	tears
tearstained	tearstained
tearstained	tearstained
zumbon	agacer
zumbon	agacer
zumbon	agacer
teasel	teasel
teaser	teaser
teaser	teaser
teases	teases
teases	teases
teases	teases
teasing	teasing
teasing	teasing
teasingly	teasingly
teasingly	teasingly
cucharita	teaspoon
cucharita	teaspoon
cucharadita	teaspoonful
teat	mamelle
teat	mamelle
teat	mamelle
teat	mamelle
teatime	teatime
teats	teats
teats	teats
diez	dix
tendencies	tendencies
tentación	aptitude
tenderfoot	tenderfoot
tenderly	tenderly
thence	thence
thence	thence
thenceforth	thenceforth
thenceforward	thenceforward
theocracy	theocracy
theocratic	theocratic
theodolite	theodolite
theologian	theologian
theologians	theologians
theological	theological
theologically	theologically
theology	theology
theorem	theorem
theorems	theorems
theoretical	theoretical
theoretical	theoretical
theoretically	theoretically
theoretician	theoretician
theoretician	theoretician
theoreticians	theoreticians
theoreticians	theoreticians
theorist	theorist
theorist	theorist
theorists	theorists
theorists	theorists
theorize	theorize
ladrón	thief
aunque	quoique
aunque	quoique
pensamiento	pensée
pensamiento	pensée
circunspecto/prudente	thoughtful
thoughtfully	thoughtfully
thoughtfulness	précaution
thoughtless	thoughtless
thoughtlessly	thoughtlessly
thoughtlessness	thoughtlessness
mil	mille
thousandth	thousandth
aporrear	thrash
aporrear	thrash
hilo	fil
hilo	fil
hilo	fil
threadbare	threadbare
amenaza/conminación	menace
amenazar/conminar	gronder
threatening	sinistre
threateningly	threateningly
tres	trois
tigress	tigress
hoy	aujourd'hui
dedo de pie	doigt du pied
tradicion	tradition
traditional	traditional
trail	trail
adiestrar/tren	clique
trainee	trainee
trainer	trainer
traitor	traitor
transaction	transaction
transalpine	transalpine
transcribir	transcribe
atravesar	passer
traducir	traduire
traducción	translation
translator	translator
despachar	adresser
árbol	arbre
camión	camiono
dos	deux
ubiquitous	ubiquitous
ubiquity	ubiquity
udder	pis
ugh	ugh
uglier	uglier
ugliest	ugliest
uglify	uglify
uglily	uglily
ugliness	ugliness
feo	laid
ukulele	ukulele
úlcera	ulcère
ulcerate	ulcerate
ulcerated	ulcerated
ulceration	ulceration
ulcerative	ulcerative
ulna	ulna
ultimo	ultimo
unemployment	unemployment
vacant	vacant
vacate	vacate
vacaciones	vacances
vacunar	vacciner
vaccinated	vaccinated
aspirador	vacuum
vacuumed	vacuumed
vagina	vagin
vagrant	vagrant
vague	vague
vanidoso	vain
wacky	wacky
wag	wag
walnut	noix
warehouse	warehouse
warehouse	warehouse
warehouses	warehouses
lavar	laver
llorar	pleurer
weeping	weeping
weeping	weeping
weeps	weeps
weepy	weepy
weepy	weepy
weevil	weevil
weft	weft
pesar	peser
pesar	peser
weighing	weighing
weighings	weighings
weighs	weighs
peso	poids
weighted	weighted
weighted	weighted
weightily	weightily
weighting	weighting
weighting	weighting
weightless	weightless
weightlessness	weightlessness
weights	weights
weights	weights
weighty	weighty
weighty	weighty
weir	weir
weird	bizarre
weirdie	weirdie
weirdies	weirdies
weirdly	weirdly
weirdness	weirdness
weirdness	weirdness
weirdo	weirdo
weirdos	weirdos
weirs	weirs
bienvenido	recevoir solennellement
bienvenido	recevoir solennellement
bienvenido	recevoir solennellement
bienvenido	recevoir solennellement
adonde	où
ventana/taquilla	fenêtre
ventana/taquilla	fenêtre
windowpane	windowpane
windowpanes	windowpanes
windows	windows
windstorm	windstorm
vino	vin
wineglass	wineglass
winegrower	winegrower
winemaker	winemaker
winemaking	winemaking
winepress	winepress
wines	wines
winey	winey
ala	aile
winglet	winglet
wink	wink
invierno	hiver
enjugar/limpiar	effacer
alambre	fil
alambre	fil
alambre	fil
wired	wired
radio	radio
wiring	wiring
wiry	wiry
sabiduria	intelligence
sabio	raisonnable
wisecrack	wisecrack
wisely	wisely
wiser	wiser
desear/deseo	désirer
desear/deseo	désirer
wishbone	wishbone
wishes	wishes
wishful	wishful
witch	witch
witches	witches
con	à
retirar	décéder
retirar	décéder
sin	sans
testigo	témoin
testigo	témoin
witnesses	witnesses
wolverine	wolverine
wolverine	wolverine
mundo	monde
worldwide	worldwide
xenophobe	xenophobe
xenophobia	xenophobia
xenophobic	xenophobic
xerographic	xerographic
xylem	xylem
xylene	xylene
xylophone	xylophone
xylophones	xylophones
xylophonist	xylophonist
xylose	xylose
xylotomic	xylotomic
yate	yacht
yachting	yachting
yachtsman	yachtsman
yak	yak
yam	igname
yap	yap
grave/patio	cour
yardstick	yardstick
yarn	yarn
bostezar	bâiller
bostezar	bâiller
yawning	yawning
yeah	yeah
año	an
yearbook	yearbook
yearlong	yearlong
anualmente	annuellement
anualmente	annuellement
yearn	aspirer
yearning	yearning
yearningly	yearningly
anos	years
yeast	yeast
yell	yell
yell	yell
amarillo	jaune
yellowed	yellowed
yellowing	yellowing
yellowish	yellowish
sí	bien
ayer	hier
aún/todavia	encore
yew	yew
abandonar/ceder	abandonner
yoga	yoga
yogur	yaourt
yogur	yogurt
yugo	yoke
yolk	yolk
tú/usted	te
tú/usted	te
joven	jeune
younger	younger
joven	youngster
juventud/joven	youth
youthful	youthful
yuppie	yuppie
zabaglione	zabaglione
zany	zany
zazen	zazen
celo	ferveur
zealous	fervent
cebra	zèbre
zenith	zenith
cero	zero
cero	zero
zest	vigueur
zigzag	zigzag
zinc	zinc
cremallera	fermeture éclair
zodiaco	zodiac
zodiaco	zodiac
zona	zone
zona	zone
jardín zoológico	zoo
zoologia	zoology
zoom	zoom
calabacín	zucchini
