en/ett	en/et
en/ett	en/et
jordsvin	aardvark
jordsvin	aardvark
aardvarks	aardvarks
bakåt	aback
bakåt	aback
bakåt	aback
abacterial	abacterial
kulram	abacus
kulram	abacus
kulram	abacus
abacuses	abacuses
abacuses	abacuses
abacuses	abacuses
akter ut	abaft
abalone	abalone
abalones	abalones
överge	abandon
överge	abandon
övergiven/övergivna	abandoned
övergiven/övergivna	abandoned
övergiven/övergivna	abandoned
abandonee	abandonee
abandoner	abandoner
abandoning	abandoning
uppgivenhet	abandonment
uppgivenhet	abandonment
abandonments	abandonments
förnedra	abase
abased	abased
förnedring	abasement
abasements	abasements
abases	abases
göra generad	abash
generad	sky
generad	sky
abasing	abasing
minska/lindra	abate
minska/lindra	abate
abated	abated
avtagande	abatement
avtagande	abatement
abatements	abatements
abates	abates
abating	abating
abating	abating
slakthus	abattoir
abbe	abbe
abberations	abberations
kloster	abbedi
kloster	abbedi
abbeys	abbeys
abbot	abbot
abbot	abbot
abbot	abbot
abbot	abbot
abbot	abbot
abbotar	abbots
förkorta	abbreviate
förkorta	abbreviate
abbreviated	abbreviated
abbreviates	abbreviates
abbreviating	abbreviating
förkortning	abbreviation
förkortning	abbreviation
förkortning	abbreviation
förkortningar	abbreviations
förkortningar	abbreviations
abbreviator	abbreviator
abdicable	abdicable
avsäga sig	abdicate
avsäga sig	abdicate
abdicated	abdicated
avsägelse	abdication
abdicator	abdicator
kropp	bug
kropp	bug
abdomens	abdomens
buk-	abdominal
abdominally	abdominally
bortföra	abduct
abducted	abducted
abducting	abducting
bortrövande	abduction
abductions	abductions
kidnappare	abductor
abductors	abductors
tvärs	abeam
alfabetisk	abecedarian
till sängs	abed
avvikelse	afvigelse
som far vilse	aberrant
aberrantly	aberrantly
villfarelse	afvigelse/fejl
villfarelse	afvigelse/fejl
aberrations	aberrations
underblåsa	abet
medhjälp	abetment
abets	abets
abetted	abetted
abetter	abetter
abetting	abetting
medhjälpare	abettor
vila	abeyance
abeyant	abeyant
avsky	abhor
abhorred	abhorred
avsky	afsky
motbjudande	abhorrent
abhorrently	abhorrently
abhorring	abhorring
abhors	abhors
stanna/vänta	abide
abided	abided
abides	abides
bestående/varaktig	uafbrudt
själsgåvor	abilities
möjlighet	formåen
möjlighet	formåen
abiotic	abiotic
föraktlig	abject
uselhet	abjection
abjectly	abjectly
avsvärjande	abjuration
avsvärja	abjure
abjurer	abjurer
borttagande	ablation
ablativ	ablative
i lågor	ablaze
i lågor	ablaze
kunna	dygtig
kunna	dygtig
kunna	dygtig
kunna	dygtig
abler	abler
ablest	ablest
i blom	abloom
tvätta sig	ablution
tvagning	ablutions
skicklig/duktigt/kunnigt	ably
avsäga sig	abnegate
abnegates	abnegates
förnekelse	abnegation
avvikande	abnormal
avvikande	abnormal
avvikande	abnormal
abnormalities	abnormalities
abnormitet	abnormality
onormalt	abnormally
ombord	aboard
boning/vistelse	lejlighed
abodes	abodes
kokande	aboil
avskaffa	afskaf
avskaffa	afskaf
abolishable	abolishable
avskaffade	abolished
abolisher	abolisher
abolishes	abolishes
abolishment	abolishment
avskaffande	abolition
avskaffande	abolition
abolitionism	abolitionism
förkämpe	abolitionist
abolitionists	abolitionists
avskyvärd	abominable
abominably	abominably
avsky	abominate
avsky	afsky
abominations	abominations
urinvånare	oprindelig
aboriginally	aboriginally
urinvånare	aborigine
aborigines	aborigines
abort	abort
avbrutits	aborted
aborter	aborter
aborting	aborting
missfall/abort	abortion
missfall/abort	abortion
abortör	abortionist
abortionists	abortionists
abortions	abortions
misslyckad	mislykked
abortively	abortively
aborts	aborts
överflöda av	abound
om/cirka	omtrent/om
ovan	oven/opad
aboveboard	aboveboard
aboveground	aboveground
abovementioned	abovementioned
abovementioned	abovementioned
abrakadabra	abracadabra
abradable	abradable
skava av	abrade
avskavning/slitning	ridse
abrasions	abrasions
sträv	skarp
abrasives	abrasives
jämsides	abreast
förkorta	indskrænke
abridged	abridged
förkortning/sammandrag	abridgement
abridging	abridging
utomlands	udenfor
avskaffa	abrogate
abrogated	abrogated
abrogation	abrogation
hastig	stejl/pludselig
abrupt	abruptly
abruptness	abruptness
böld	absces/absces
abscesses	abscesses
rymma	abscond
absconded	absconded
frånvaro	fraværelse/mangel
absences	absences
frånvarande	fraværende
frånvarande	absentee
skolk	absenteeism
absentees	absentees
frånvarande	absently
absentminded	absentminded
absentmindedly	absentmindedly
absentmindedly	absentmindedly
absentmindedness	absentmindedness
absinth	absinth
absinthe	absinthe
absolut	absolute
absolut	absolutely
frikännande	benådning
envälde	absolutism
frikänna	absolve
absolved	absolved
absolving	absolving
uppta	indsuge
absorbability	absorbability
absorbable	absorbable
absorbant	absorbant
ingick i	absorbed
absorberande	absorbent
absorberande	absorbing
absorbering	absorption
avstå	abstain
abstained	abstained
återhållsam	afholdende
röstnedläggelse	abstention
abstentions	abstentions
röstnedläggelse/återhållsamhet	abstinence
måttlig	abstinent
abstinently	abstinently
abstrakt	slutte/tage bort
abstrakt	slutte/tage bort
abstraktion	tyveri
dunkel	abstruse
orimlig	absurd
absurdism	absurdism
absurdist	absurdist
absurdities	absurdities
orimlighet	absurdity
överflöd	rigdom
överflödande	abundant
abundantly	abundantly
missbruk	fornærme/fornærmelse
missbrukat	abused
ovettig/smädlig	abusive
abusively	abusively
gränsa intill	abut
abuzz	abuzz
bottenlös	abysmal
abysmally	abysmally
avgrund	afgrund
avgrund	afgrund
abysses	abysses
abysses	abysses
akacia	akacie
akademisk	student
akademisk	academical
akademiskt	academically
akademimedlem	academician
academies	academies
academism	academism
akademi	akademi
acanthus	acanthus
acanthuses	acanthuses
tillträda/biträda	samtykke
tillträda/biträda	samtykke
accelerera	accelerate
accelererade	accelerated
acceleration	acceleration
accelerations	accelerations
gaspedal	accelerator
accelerators	accelerators
accelerometer	accelerometer
accelerometers	accelerometers
tonvikt	betoning
betonade	betonede
betonade	betonede
accents	accents
accentual	accentual
accentually	accentually
betona	lægge vægt på
accentuated	accentuated
betoning	accentuation
acceptera	modtage
godtagbarhet	acceptability
godtagbart	acceptable
acceptabelt	acceptably
accepterande	acceptance
accepterad	accepted
accepter	accepter
acceptant	acceptor
tillgång	tilgang
åtkomliga	accessed
accessibility	accessibility
åtkomlig	accessible
tillträde/tillskott	erhverv/erhvervelse
accessorial	accessorial
tillbehör	accessories
accessorize	accessorize
accessors	accessors
tillbehör	accessory
olycka	ulykke/ulykkestilfælde
tillfällig	tilfældig
accidentalism	accidentalism
accidentalist	accidentalist
händelsevis	accidentally
accidently	accidently
olyckor	accidents
hylla/hälsa såsom	bifald
bifallsrop	bifald/applaus
acclimate	acclimate
acclimated	acclimated
anpassa	tilpasse
dubbning till riddare	accolade
accolades	accolades
anpassa	accommodate
anpassad	accommodated
tillmötesgående	accommodating
anpassning	samtykke/lejlighed
accommodations	accommodations
accompanied	accompanied
accompanier	accompanier
accompanies	accompanies
ackompanjemang	accompaniment
accompaniments	accompaniments
ackompanjatör	accompanist
accompanists	accompanists
ackompanjera	ledsage
accompanyist	accompanyist
accompanyists	accompanyists
medbrottsling	accomplice
accomplices	accomplices
utföra	fuldbyrde
presterade	accomplished
prestation	accomplishment
accomplishments	accomplishments
bevilja/medge	akkord
enlighet	accordance
accorder	accorder
accorders	accorders
dragspel	trækharmonika
accordionist	accordionist
accordionists	accordionists
accordions	accordions
accords	accords
tilltala	accost
beräkning	konto
ansvarighet	accountability
ansvarig/förklarlig	accountable
bokförare	accountant
bokföring	accounting
accouterment	accouterment
accrued	accrued
accruement	accruement
samlat	accumulated
acetaminophen	acetaminophen
acetify	acetify
aceton	acetone
sur	sur
acidic	acidic
allergen	allergen
allergen	allergen
allergisk	allergic
allergier	allergies
allergier	allergies
allergi	allergy
allergi	allergy
mildra	alleviate
lätta	lette
gränd	stræde
gränd	stræde
alleys	alleys
alleys	alleys
förbindelse	alliance
förbindelse	alliance
alliances	alliances
alliances	alliances
allierad	allied
allierad	allied
alligator	alligator
alligator	alligator
alligators	alligators
alligators	alligators
alliteration	alliteration
alliteration	alliteration
alliterations	alliterations
alliterations	alliterations
tilldela	allocate
tilldelat	allocated
tilldelning	allocation
tilldelning	allocation
tilldelningen	allocations
allocution	allocution
allocution	allocution
allocution	allocution
fördela	allot
tillåta	tillade
tillåtna	allowable
tillstånd	allowance
tillåten	allowed
legering	legering
alfabete	alfabet
alfabetisk	alphabetic
alfabetisk	alphabetical
alphabetization	alphabetization
alphabetizations	alphabetizations
alphabetize	alphabetize
alphabetized	alphabetized
alphabetizing	alphabetizing
alfabeten	alphabets
alphamerical	alphamerical
alfanumerisk	alphanumeric
alphanumerical	alphanumerical
alphanumerically	alphanumerically
alphanumerics	alphanumerics
alpin	alpine
alpinism	alpinism
alpinist	alpinist
redan	allerede
även	også
gräl	altercation
altercations	altercations
växla	alternate
alternated	alternated
alternativt	alternately
bland	mellem
amoralisk	amoral
kärleksfull	amorous
amorously	amorously
formlös	amorphous
summa	antal/beløb/sum
summa	antal/beløb/sum
ampere	amp
ampere	ampere
ampersand	ampersand
amfetamin	amphetamine
och	og
hursomhelst	anyway
varsomhelst	nogensteds
aorta	aorta
snabbt	apace
isär	særskilt
apartheid	apartheid
lägenhet	apartment
apatisk	apathetic
apati	apathy
människoapa	abe
människoapa	abe
aperitif	aperitif
öppning	aperture
spets	apex
aphid	aphid
anländer	ankomme
aspen	aspen
granska/revidera	kontrolere
mötessal	auditorium
auditoriums	auditoriums
audits	audits
tillgänglig	available
pladdra/sorl	babble
pratmakare	babbler
babies	babies
babian	baboon
barn	baby/spædbarn
kandidatexamen	baccalaureate
baccarat	baccarat
ungkarl	bachelor
ungkarlar	bachelors
bacilli	bacilli
bacill	bacillus
tillbaka	ryg/tilbage
ryggsmärtor	backache
baktala	backbite
ryggrad	backbone
bakgrund	background
backgrounds	backgrounds
bak	backside
återfalla	backslide
ta kopia	backup
bakåt	backward
sidfläsk	bacon
bakterie	bacteria
dålig	dårlig/ond
emblem	mærke
badged	badged
badgers	badgers
raljeri	badinage
väska	taske
bagatell	bagatelle
bagatelles	bagatelles
bagage	bagage
påsar	poser
list	baguette
bah	bah
borgen	bail
agn	bait
baka	bage
bagare	bager
bakeries	bakeries
bakers	bakers
bageri	bageri
bakeshop	bakeshop
balans	balance
balconies	balconies
balkong	balkon
skallig/kal	bald
baldhead	baldhead
rakt på sak	baldly
skallighet	baldness
bal/packe	bale
valfiskben	baleen
hindra	balk
boll/kula	bal/bold
visa	ballad
ballad	ballade
ballader	ballads
barlast	ballast
balett	ballet
balletic	balletic
ballong	ballon
valsedel/sluten omröstning	ballot
ballar/bollar	bolde
ballyhoo	ballyhoo
balsam	balsam
bambu	bambus
lura	bamboozle
banan	banan
bananas	bananas
musikkår	bande
bandage	bandage
hårband	bandeau
bandit	bandit
bandits	bandits
bandleader	bandleader
kapellmästare	bandmaster
fördärv	bane
fördriven	banished
hulling	barb
barbar	barbarian
barbarer	barbarians
barbarismen	barbarism
frisör	frisør
barflicka	barmaid
bartender	barman
kaserner	kaserne
stranden	strand
bära	bjørn
bära	bjørn
säng	bed/seng
sovrum	sovekammer/soveværelse
tro	tro
förråda	betray
bibliographic	bibliographic
bibliografier	bibliographies
källförteckning	bibliography
björnbär	brombær
bok	bog/bestille
boomerang	boomerang
boxer	bokser
pojke	dreng
pojkar	boys
hjärna	hjerne
kull/yngel/ruva/grubbla	brood
kvast/ginst	kost/fegekost
buljong/köttsoppa	broth
bygga	bygge
byggnad	bygning
hejdå	farvel
droska/förarhytt	cab
kabal	cabal
cabala	cabala
cabalism	cabalism
cabalist	cabalist
cabalistic	cabalistic
caballero	caballero
krog	cabaret
kål	kål
cabbages	cabbages
cabdriver	cabdriver
hytt	hytte/kahyt
skåp/kabinett	skab
cabinetmaker	cabinetmaker
cabinetmakers	cabinetmakers
cabinets	cabinets
hytter	cabins
kabel	cable
cabled	cabled
cablegram	cablegram
cablegrams	cablegrams
kablar	kabler
cabling	cabling
chaufför	cabman
kabyss	caboose
kustfart	cabotage
cabriolet	cabriolet
cabs	cabs
kakao	cacao
cacciatore	cacciatore
kaskelot	cachalot
gömställe	cache
cachepot	cachepot
caches	caches
kackel/kackla/prat/fnitter	cackle
cackled	cackled
cackles	cackles
cackling	cackling
missljud	cacophony
cacti	cacti
kaktus	cactus
lymmel	cad
cadaver	cadaver
cadaverous	cadaverous
caddies	caddies
teburk	caddy
cadence	cadence
yngre son/kadett	cadet
cadetship	cadetship
cadge	cadge
cadger	cadger
cafe	cafe
cafes	cafes
cafeteria	cafeteria
cafeterias	cafeterias
caffeine	caffeine
caftan	caftan
bur	cage
burar	cages
cahier	cahier
röse	cairn
cairns	cairns
caitiff	caitiff
smickra	cajole
cajoler	cajoler
mild övertalning	cajolery
tårta/bakelse/kaka	kage
tårta/bakelse/kaka	kage
kalcium	calcium
beräkna	beregne
beräknad	calculated
kalibrera	calibrate
calibrated	calibrated
calibration	calibration
bil	bil/automobil
carbonization	carbonization
carbonize	carbonize
carbonized	carbonized
carbonless	carbonless
carburetor	carburetor
carburetors	carburetors
carburization	carburization
carburize	carburize
kort	card
cardamom	cardamom
cardiac	cardiac
kofta/stickad ylleväst	cardigan
cardioid	cardioid
cardioids	cardioids
varsamhet	sorg
varsamhet	sorg
cared	cared
karriär	karriere
försiktig	forsigtig
noggrannt	carefully
katt	kat
cell	cell
cellular	cellular
chans	tilfælde/lejlighed
cherries	cherries
kyrkan	kirke
kyrkorna	kirker
kappa	cloak
cloaks	cloaks
klocka	ur
clockmaker	clockmaker
medsols	clockwise
pelargång/kloster	cloister
klon	clone
moln	sky
clouds	clouds
kol	kul
dator	computer
datorer	computere
kamrater	kammerater
hemliga	concealed
conjuring	conjuring
begrunda/ha för avsikt	contemplate
begrunda/ha för avsikt	contemplate
begrunda/ha för avsikt	contemplate
contemplates	contemplates
contemplation	contemplation
contemplation	contemplation
contemplation	contemplation
contemplations	contemplations
contemplations	contemplations
contemplative	contemplative
contemporaneous	contemporaneous
contemporaneously	contemporaneously
contemporaries	contemporaries
contemporaries	contemporaries
samtidig/samtida/jämnårig	contemporary
samtidig/samtida/jämnårig	contemporary
förakt	foragt
förakt	foragt
contemptible	contemptible
contemptibly	contemptibly
föraktfull/hånfull	contemptuous
föraktfull/hånfull	contemptuous
contemptuously	contemptuously
contemptuously	contemptuously
strida/tävla/påstå	contend
strida/tävla/påstå	contend
strida/tävla/påstå	contend
contender	contender
contender	contender
contender	contender
contenders	contenders
contenders	contenders
contenders	contenders
contending	contending
contending	contending
contends	contends
contends	contends
innehåll	content
innehåll	content
innehåll	content
tillfredsställd	tilfreds
tillfredsställd	tilfreds
contentedly	contentedly
contentedness	contentedness
contention	contention
contention	contention
contention	contention
contentions	contentions
contentions	contentions
contentions	contentions
contentious	contentious
contentious	contentious
belåtenhet	contentment
innehåll	indhold
innehåll	indhold
strid/bestrida/tävlan	contest
strid/bestrida/tävlan	contest
strid/bestrida/tävlan	contest
contestant	contestant
contestant	contestant
babysång/vagga/barnsäng	cot
coterie	coterie
cotillion	cotillion
cotillon	cotillon
villa/stuga	cottage
cottager	cottager
soffa	couch
hosta	hoste
coughs	coughs
räkna	beregne/tælle
ansikte	countenance
motverka	counteract
counterbalance	counterbalance
countermand	countermand
countermarch	countermarch
counterplot	counterplot
kontrapunkt	counterpoint
counterpoise	counterpoise
counterweight	counterweight
grevinna	countess
oräkneliga	countless
land	land
landsman/lantman	countryman
countrywide	countrywide
grevskap/län	amt
par	ægtepar
verspar	couplet
kupong	coupon
mod	mod
modig	modig/tapper
courageously	courageously
kurir/löpare	courier
kurs/bana	fad
springare/harjägare	courser
domstol	gård
hövlig	høflig
courteously	courteously
courteousness	courteousness
artighet	courtesy
courthouse	courthouse
hovman	courtier
courtliness	courtliness
elegant/artig	courtly
courtmartial	courtmartial
courtroom	courtroom
courtship	courtship
kusin	kusine/fætter
bukt	cove
avtal/förbund	aftale
täcka	indbinding/dække
hemlig/gömställe	covert
eftertrakta	covet
covetous	covetous
covetously	covetously
ko	ko
ko	ko
feg/stackare	coward
feghet	fejghed
cowardly	cowardly
krypa ihop	cower
cowherd	cowherd
huva/rökhuv	cowl
sprätt	coxcomb
blyg/pryd	coy
coyly	coyly
coyness	coyness
prärievarg	coyote
cozily	cozily
cozy	cozy
crabapple	crabapple
crabbed	crabbed
spricka upp	revne
smällkaramell/knäckare	cracker
spraka	crackle
vagga	cradle
hantverk/fartyg/flygplan	craft
craftily	craftily
brant klippa/klippspets	crag
stoppa/packa	cram
kramp/hindra	cramp
tranbär	cranberry
trana/lyftkran	crane
cranium	cranium
crankiness	crankiness
cranky	cranky
crape	crape
krascha	crash
packkorg/spjällåda	crate
crater	crater
be om/längta efter	crave
feg	craven
kravla	krybe
kräfta	krebs
färgkrita	crayon
mani	craze
crazily	crazily
tokiga	crazy
knarra	creak
grädde	fløde
creamy	creamy
veck/rynka	crease
skapa	danne
skapelse	creation
skapare	creator
varelse	creature
tilltro	credence
credential	credential
kredit	credit
creditable	creditable
creditably	creditably
borgenär/fordringsägare	creditor
credo	credo
credulity	credulity
godtrogen	credulous
credulously	credulously
trosbekännelse	creed
liten vik/bukt	creek
krypa/smyga	krybe
kryper	creeps
bränna	cremate
klipp	klippe/skære
söt	cute
söt	cute
cuteness	cuteness
cutoffs	cutoffs
cutout	cutout
klipper	cuts
kniv/tillskärare	cutter
sågning	cutting
cyanate	cyanate
cyanid	cyanide
cybernetic	cybernetic
cybernetician	cybernetician
cybernetics	cybernetics
cykel	cykel
cyclic	cyclic
konjunkturbetingad	cyclical
cyclist	cyclist
cyklister	cyclists
cycloid	cycloid
cycloidal	cycloidal
cyclone	cyclone
cyclonic	cyclonic
cyclopean	cyclopean
cyclotron	cyclotron
cylinder	cylinder
pappa	dad
daddies	daddies
pappa	daddy
dads	dads
tokig	daffy
tokig	daft
dolk	dolk
dahlia	dahlia
dahlias	dahlias
daglig	daglig
daintier	daintier
utsökt/fin	dainty
mejeri/mjölkbutik	mejeri
dalmatisk	dalmatian
dalmatians	dalmatians
damm/dämma upp/djurmoder	dam
skada	skade/beskadige
skada	skade/beskadige
skada	skade/beskadige
skada	skade/beskadige
skadade	damaged
skadade	damaged
damager	damager
damagers	damagers
skador	damages
damaging	damaging
dame	dame
dammit	dammit
fördömelse	damnation
förbaskade	damned
fuktig	damp
bli fuktig	dampen
dampened	dampened
dampness	dampness
dams	dams
dansa	bal
dansör/dansös	dancer
dansare	dansere
dansande	dancing
maskros	dandelion
dandelions	dandelions
dandies	dandies
mjäll	dandruff
fara	fare
farliga	farlig
pil/rusa	dart
dag	dag
gryning	daggry
dagsljus	daylight
dagar	dage
avaktivera	deaktivere
deactivation	deactivation
död	død
döv	døv
dödens	dødens
djup	dyb
densitet	density
förtjäna	fortjene
detat	detat
detre	detre
tillbehör	apparat
tillbehör	apparat
dictated	dictated
dikterar	dictates
diktamen/diktat/maktbud	dictation
dictations	dictations
ordböcker	ordbøger
lexikon	ordbog
gjorde	did
dö	dø
dött	died
disel	diesel
kost	diæt
dietetically	dietetically
diets	diets
annorlunda/olika	forskellig
svårigheter	difficulties
svårighet	difficulty
gräva/grävde/grävt	grave
digested	digested
dignitaries	dignitaries
dignities	dignities
värdighet	dignity
utvidga	dilate
dilated	dilated
doktor	doktor/læge
doeuvre	doeuvre
hund	hund
doggie	doggie
hundar	dogs
dricka	drik/drikke
drinkar	drikker
köra/enhet	køre
duggregn	drizzle
torr	tør/tørre
anka/and/ducka	and
varje	ethvert
örn	ørn
örnar	eagles
eaglet	eaglet
öra	øre
earache	earache
eardrum	eardrum
eardrums	eardrums
earlobe	earlobe
tidig	tidlig
förtjäna	fortjene
earning	earning
earphones	earphones
earring	earring
earrings	earrings
öron	ears
jorden	jord
jordbävning	jordskælv
jordbävningar	earthquakes
earths	earths
daggmask	earthworm
earthworms	earthworms
earwax	earwax
lätthet	ease
staffli	bænk
lättare	lettere
lättaste	easiest
med lätthet	easily
easiness	easiness
östra	øst
påsk	påske
lätt	let/nem
äta	æde/spise
eatable	eatable
äter	spiser
ebenholts	ebony
original/originell	eccentric
eccentricity	eccentricity
ecclesiastic	ecclesiastic
eko	ekko
månförmörkelse/förmörka	eclipse
ecologic	ecologic
miljöforskare	ecologist
miljöforskning	ecology
nationalekonomi	economics
ecru	ecru
åtta	otte
arton	atten
eighteenth	eighteenth
eightfold	eightfold
åttonde	ottende
åttitalet	eighties
eightieth	eightieth
åttio	firs
eightyfold	eightyfold
einsteinium	einsteinium
varje	either
utropa	ejaculate
ejaculated	ejaculated
ejaculates	ejaculates
ejaculating	ejaculating
utrop	ejaculation
ejaculations	ejaculations
ejaculatory	ejaculatory
tar ut	eject
ejectable	ejectable
ejecting	ejecting
ejection	ejection
ejector	ejector
ejectors	ejectors
genomarbeta/utveckla	elaborate
elaborated	elaborated
genomarbetar/utvecklar	elaborates
elaborating	elaborating
elaboration	elaboration
elaborations	elaborations
hiss	elevator
elva	elleve
eleventh	eleventh
avlägsna	fjern
slut/avsluta	fuldende/endelse/ende
miljö	omgivelse
sändebud	bud
avund/avundas	misunde
avund/avundas	misunde
rulltrappa	escalator
etablera	etablere
händelse	tildragelse/lejlighed
eventual	eventual
eventuellt	eventually
någonsin	nogensinde
evergreen	evergreen
ständig/evig	everlasting
varje	every
överallt	overalt
vräkning	eviction
bevis	evidence
utropa	exclaim
fable	fabel
fables	fables
tyg	fabric
fabricant	fabricant
uppfinna/förfalska	fabrikere
fabricated	fabricated
fabricates	fabricates
fabricating	fabricating
påhitt/lögn	fabrication
fabrications	fabrications
fabricator	fabricator
fabricators	fabricators
tyger	fabrics
fabulist	fabulist
fabulous	fabulous
facade	facade
facades	facades
faceless	faceless
faceplate	faceplate
facet	facet
skämtsam	facetious
skämtsam	facetious
facetiously	facetiously
ansikts-	facial
facies	facies
facile	let/nem
underlätta	facilitate
främjandet	facilitated
facilitates	facilitates
facilitating	facilitating
möjligheter	facilities
hjälpmedel	hjælpemiddel
vara vänd mot	facing
faksimil	facsimile
faktum	faktum
parti/partigrupp/split	parti
faktor	factor
factorial	factorial
factorials	factorials
fabriker	fabrikker
factorization	factorization
factorizations	factorizations
factorize	factorize
factorized	factorized
faktorer	factors
fabrik	fabrik
fakta	facts
factual	virkelig
facultative	facultative
facultatively	facultatively
faculties	faculties
förmåga/fakultet	fakultet
vurm/mani	fad
tyna	fade
tynade	faded
fader	fader
faders	faders
fading	fading
faery	faery
faience	faience
fela	fail
svimma/svag	svag
faintly	faintly
skaplig/ärlig	retfærdig
tämligen/ärligt	fairly
fe	fairy
trogen	trofast
troget	faithfully
modern/elegant	fashionable
snabbt	fast/hurtig
fäste	fastener
kräsen	fastidious
fet	tyk/fed/fedt
ödesdigert/dödlig	fatal
fatalism	fatalism
svår olycka	fatality
fatally	fatally
ödet	bestemmelse
fisk	fiske/fisk
fishable	fishable
fishbowl	fishbowl
fished	fished
fisher	fisher
fisheries	fisheries
fiskare	fisherman
fishermen	fishermen
fishers	fishers
fishery	fishery
fishes	fishes
fisket	fishing
fishtail	fishtail
klyvning	fission
fissionable	fissionable
klyfta/klyvning	fissure
knytnäve	næve
fisted	fisted
fistful	fistful
fem	fem
fivefold	fivefold
laga	befæste/reparere
fixation	fixation
fixations	fixations
fixity	fixity
fast tillbehör	fixture
fixtures	fixtures
fjord	fjord
fjords	fjords
flygtur	flugt
diskett	floppy
fluently	fluently
fot	fod/pote
fotboll	fodbold
glömma	glemme
glömskt	forgetful
glömska	forgetfulness
forgivable	forgivable
forgivably	forgivably
förlåt	forlade
förlåtelse	forgiveness
forgives	forlader
forgiving	forgiving
avstå från/uppge	forgo
forgoes	forgoes
glömd	forgotten
övergiven/hopplös	forlorn
formaldehyde	formaldehyde
fyra	fire
räv	ræv
fraktal	fractal
fraktaler	fractals
fraktion	fraction
fractionate	fractionate
broderlig	fraternal
fraternize	fraternize
vän	veninde/ven
vänskap	venskab
frans/kanta	fringe
groda	frø
frogs	frogs
från	fra
fram	frem
knullad/knullade	fucked
fudge	fudge
fugue	fugue
fulgurant	fulgurant
rädsla	funk
roligaste	sjoveste
kul	morsom/sjov
prat	gab
gabardine	gabardine
gabber	gabber
gabbing	gabbing
gaberdine	gaberdine
hjälpmedel	gadget
glädje	glæde
glatt	gaily
vinna	erhverv/fortjene
vunnit	gained
gaining	gaining
gala	gala
galactic	galactic
lysande samling	galaxy
tapper/artig	gallant
gallantly	gallantly
gallantry	gallantry
galleries	galleries
galleri/läktare	gallery
gallon	gallon
galopp/galoppera	gallop
galloped	galloped
galloping	galloping
galvanic	galvanic
galvanism	galvanism
uppliva/galvanisera	galvanize
galvanized	galvanized
spel	leg/spil
spel	games
vitlök	hvidløg
gas/gasa/prat/bensin	gas
bensin	benzin
ghostwriter	ghostwriter
present	gave
gåvor	gaver
gå/starta	gå/fare
mål	hensigt/mål
mål	goals
get	ged
gud	gud
gudinna	goddess
gudinnor	goddesses
godfather	godfather
golf	bugt
golfer	golfer
golfers	golfers
golfs	golfs
bra	god
bra	god
adjö	farvel/afsked
godnatt	goodnight
gopher	gopher
klänning/dräkt	kjole
gripa tag i	gribe
stigning	gradient
gradvis	efterhånden/gradvis
språklära	grammar
druva	vindrue
grapefruit	grapefruit
habilitated	habilitated
habilitation	habilitation
vana	sædvane
habitant	habitant
habitants	habitants
naturlig hemvist	habitat
boning/boningsplats	habitation
sed/sedvanlig	habitual
hade	havde
hand	arbejder/hånd
huvud	hoved
heats	heats
himmelskt	himmel
tung	tung
hectare	hectare
hectares	hectares
hectoliter	hectoliter
igelkott	hedgehog
bekymra sig om	heed
häl/klack/klacka	hæl
heeler	heeler
heels	heels
höjd	højde
höll	held
helices	helices
helvete	hell
hallå/hej	goddag
roder/styre	ror
hjälm	helmet
hjälp	hjælp/hjælpe
hampa	hemp
höna	høne
hjord/skock	herd
här	herhen/hid/her
häger	hejre
höfter	hips
träff	slå/banke
hockey	hockey
hogwash	hogwash
holidayer	holidayer
ledigheter	holidays
hem	hjem
hemlösa	homeless
hem	homes
hus	hus
is	is
instancing	instancing
internship	internship
stöt/stöta/sticka	jab
rotvälska/pladder/pladdra	jabber
jabberwocky	jabberwocky
jabberwocky	jabberwocky
domkraft	donkraft
schakal	jackal
jackals	jackals
åsnehingst	jackass
kaja	jackdaw
jacka/rock	jacket
jacka/rock	jacket
jackknife	jackknife
pott	jackpot
hästkrake/jade	jade
utsliten/blaserad	jaded
jag	jag
ojämn	jagged
fängelse	fængsel
fängelse	fængsel
jailbreak	jailbreak
jailed	jailed
fångvaktare	jailer
jailing	jailing
jailor	jailor
fängelser	jails
rishög	jalopy
klämma/blockera/sylt	syltetøj
klämma/blockera/sylt	syltetøj
karm	jamb
packad	jammed
packad	jammed
gnissla/oljud	jangle
portvakt	janitor
portvakt	janitor
burk/gräla/gnissla	jar
burk/gräla/gnissla	jar
burk/gräla/gnissla	jar
rotvälska/jargong	jargon
jasmin	jasmine
gulsot	jaundice
utfärd	jaunt
ogenerad/nonchalant	jaunty
spjut	javelin
käke	kæbe
käkar	jaws
nötskrika	jay
jazz/snack/pigga upp	jazz
jazzig/gräll	jazzy
svartsjuk	misundelig
avundsjuka	skinsyge
hån/håna	jeer
hån/håna	jeer
gelé	jelly
jellyfish	jellyfish
äventyra	jeopardize
äventyra	jeopardize
ryck/rycka/stöt	jerk
ryck/rycka/stöt	jerk
tysk	jerry
tröja/ylletröja	jersey
tröja/ylletröja	jersey
skämt/skämta	spøge
skämtare	jester
skämtare	jester
stråle/låga/jet	jet
stråle/låga/jet	jet
kasta överbord	jettison
pir/kaj/brygga	jetty
juvel	ædelsten
jeweler	jeweler
jewelery	jewelery
jewelry	jewelry
juveler	jewels
klyvare/streta emot	jib
klyvare/streta emot	jib
ögonblick	jiffy
jigg	jig
lövsåg	jigsaw
heligt krig	jihad
trolös/kvinna/svika	jilt
klirra/klirrande	ringe
klirra/klirrande	ringe
klirra/klirrande	ringe
dra olycka	jinx
nervositet/panik	jitters
arbete	arbejde
arbete	arbejde
arbete	arbejde
arbetslös	jobless
jockej	jockey
skämtsam	jocular
glad/glättig/munter	jocund
jodhpur	jodhpur
knuffa/lunka	jog
jogging	jogging
gå med	binde/forene
gå med	binde/forene
joinable	joinable
gått med	joined
möbelsnickare	joiner
snickeri	joinery
skarv	joint
skarv	joint
skarv	joint
gemensamt	jointly
skämta	spøge
skämta	spøge
skojade	joked
skämtare	joker
på skämt	jokingly
på skämt	jokingly
glad/väldigt	jolly
skaka/skakning	jolt
skaka/skakning	jolt
jonquils	jonquils
knuffa/knuffas	jostle
jota/annotera	jot
jota/annotera	jot
dagbok/tidning	avis
dagbok/tidning	avis
journalistik	journalism
journalist	journalist
journalister	journalists
resa	rejse
resa	rejse
gemytlig	jovial
jovially	jovially
glädje	glæde
glad/glädjande	joyful
glädjelös	joyless
joyously	joyously
jubileum	jubilee
domare	dømme/dommer
domare	dømme/dommer
dömts	judged
omdöme	judgement
rättslig	judicial
domarna	judiciary
judo	judo
krus/tillbringare	kande/beholder
krus/tillbringare	kande/beholder
krus/tillbringare	kande/beholder
gudabild	juggernaut
jonglera	jonglere
jonglör	juggler
halsblodåder	jugular
saft	saft
saftlös	juiceless
juicier	juicier
juiciest	juiciest
saftig	juicy
jukebox	jukebox
röra	jumble
klumpeduns	jumbo
hoppa	springe/spring
hoppade	jumped
nervös	jumpy
knutpunkt	junction
knutpunkt	junction
jungel	jungle
yngre/lägre	junior
enbuske	juniper
lump/skräp/djonk	junk
lump/skräp/djonk	junk
lump/skräp/djonk	junk
lump/skräp/djonk	junk
junkers	junkers
junkers	junkers
knarkare	junkie
knarkare	junkie
junkyard	junkyard
juridic	juridic
rättskipning	jurisdiction
rättslärd	jurist
jurymedlem	juror
jurors	jurors
jury/nämnd	jury
bara	retfærdig/kun
rättvisa/rätt	retfærdighed
rättfärdigat	justified
rättfärdiga	justify
rättvist	justly
sticka fram	jut
ungdomlig	juvenile
placera vid sidan	juxtapose
kål	kale
kaleidescope	kaleidescope
kaleidoscope	kaleidoscope
känguru	kangaroo
karat	karat
karate	karate
kayak	kayak
kebab	kebab
köl	køl
fortsätta/behålla	beholde
behåller	keeps
suvenir	souvenir
kagge/kutting	keg
kagge/kutting	keg
hundkoja/hundgård	kennel
hundkoja/hundgård	kennel
huvudduk	kerchief
kärna/korn	kærne
kärna/korn	kærne
kärna/korn	kærne
fotogen	kerosene
ketchup	ketchup
kittel	kedel
tangent	nøgle
tangent	nøgle
tangent	nøgle
tangentbord	keyboard
keyhole	keyhole
keying	keying
grundton/klav	keynote
keypad	keypad
khaki	khaki
spark/sparka/kick	sparke/spark
spark/sparka/kick	sparke/spark
motreaktion	kickback
kicked	kicked
kicker	kicker
kickoff	kickoff
kicks	kicks
unge	kid
unge	kid
unge	kid
kiddies	kiddies
kiddies	kiddies
kiddies	kiddies
röva bort	kidnap
kidnaped	kidnaped
kidnaper	kidnaper
kidnaper	kidnaper
kidnapers	kidnapers
kidnaping	kidnaping
kidnapped	kidnapped
kidnapper	kidnapper
kidnappers	kidnappers
kidnapping	kidnapping
kidnappings	kidnappings
njure	kidney
kidneys	kidneys
kidneys	kidneys
ungar	kids
ungar	kids
ta bort	dræbe
ta bort	dræbe
mördare	killer
mördare	killer
killers	killers
dödande	killing
dödande	killing
killings	killings
killjoy	killjoy
brännugn	ovn
kilo	kilo
kilogram	kilogram
kilohertz	kilohertz
kiloliter	kiloliter
kilometer	kilometer
kilowatt	kilowatt
kilt	kilt
släkt	kin
vänlig/sort	venlig/godhjertet/art
vänlig/sort	venlig/godhjertet/art
vänlig/sort	venlig/godhjertet/art
lekskola	kindergarten
lekskola	kindergarten
lekskola	kindergarten
lekskola	kindergarten
kindhearted	kindhearted
kindhearted	kindhearted
kindheartedness	kindheartedness
tända	tænde
tända	tænde
kindlessly	kindlessly
kindlessly	kindlessly
kindliness	kindliness
kindliness	kindliness
välvilligt	kindly
välvilligt	kindly
välvilligt	kindly
välvilligt	kindly
vänlighet	kindness
vänlighet	kindness
släktskap	kindred
släktskap	kindred
vänliga	kinds
vänliga	kinds
kung	dame
kungarike	kingdom
kungarike	kingdom
kungariken	kingdoms
kingfisher	kingfisher
konungslig	kingly
kungar	kings
krullig/excentrisk	kinky
kiosk	kiosk
rökt fisk/rökt sill	kipper
kysser/kyss	kysse/kys
kysser/kyss	kysse/kys
kysser/kyss	kysse/kys
kysser/kyss	kysse/kys
kyssar	kisses
kyssar	kisses
utrustning/packning	kit
utrustning/packning	kit
kök	køkken
kokvrå	kitchenette
kitchens	kitchens
kitchenware	kitchenware
kitchenware	kitchenware
glada/drake	kite
släktingar	kith
kiting	kiting
kattunge	kitten
kattungar	kittens
kitty	kitty
kiwi	kiwi
kiwi	kiwi
kleenex	kleenex
kleenex	kleenex
kleptomania	kleptomania
kleptomaniac	kleptomaniac
knep/vana	knack
knep/vana	knack
ryggsäck	knapsack
knåda	knead
kneadable	kneadable
kneader	kneader
knä	knæ
knäskål	kneecap
knäböjer	knæle
knäböjer	knæle
knäande	kneeling
knäande	kneeling
kneepad	kneepad
knäböjde	knelt
knäböjde	knelt
dambyxor	knickers
knickknack	knickknack
knickknack	knickknack
kniv	kniv
kniv	kniv
knifes	knifes
knifing	knifing
riddare/adelsman/adla	knight
riddare/adelsman/adla	knight
knighted	knighted
knighthood	knighthood
knightly	knightly
knights	knights
sticka/rynka	knit
sticka/rynka	knit
sticka/rynka	knit
knitted	knitted
stickning	knitting
trikåvaror	knitwear
knivar	knives
vred	knob
vred	knob
knölig	knobby
knobs	knobs
slå	banke
knockdown	knockdown
knockout	knockout
knut/knop	knude
knots	knots
knölig	knotted
knölig/kvistig	knotty
veta	vide
knower	knower
knowhow	knowhow
knowhow	knowhow
veta	knowing
medvetet	knowingly
medvetet	knowingly
kunskap	kundskab
kunskap	kundskab
kunnig	knowledgeable
kända	kendte
vet	knows
knoge	knuckle
knoge	knuckle
knucklebone	knucklebone
knogar	knuckles
koala	koala
koala	koala
kosher	kosher
kraut	kraut
kraut	kraut
krauts	krauts
kudzu	kudzu
labb	lab
arbeta	labor
laborer	arbejder
laborer	arbejder
laborers	laborers
snöre/snöra/spets/spetsar	spidser
laceration	laceration
lacerations	lacerations
avsaknad	mangel
lackadaisical	lackadaisical
lakej	lackey
bristen	lacking
lackluster	lackluster
laconic	laconic
laconically	laconically
fernissa	fernis
fernissa	fernis
pojke	lad
damer	ladies
dam/kvinna	dame
ladybird	ladybird
ladybug	ladybug
sjö	sø
sjöar	lakes
lamm	lam
lambs	lambs
laminated	laminated
laminates	laminates
lampa/lykta	lampe
språk	sprog
skratta	le
läder	læder
lämna	afrejse/lade
läspulpet	lectern
föreläsning/föreläsa	lektie/foredrag
föreläsare	lecturer
hylla	ledge
huvudbok/liggare	ledger
lä/läsida	lee
ben	ben
giltiga	gyldige
laglighet	legality
legalisera	legalize
lagligt	legally
påvlig legat	legate
legation	legation
legend/sägen	legend
legendariska	legendary
legion	legion
brev	brev/bogstav
brev	brev/bogstav
brev	brev/bogstav
gilla/som	synes om
leva	bo/leve
älska/kärlek	elske/kærlighed
älska/kärlek	elske/kærlighed
älskare	lover
tur	held
lunch/luncha	lunch
mamma	moder/mor
mamma	moder/mor
maam	maam
maam	maam
maam	maam
makaber	macabre
makaber	macabre
macabrely	macabrely
makadam	macadam
makadam	macadam
macadamize	macadamize
macadamize	macadamize
macadamized	macadamized
macadamized	macadamized
macadamizes	macadamizes
macadamizes	macadamizes
macadamizing	macadamizing
macaque	macaque
macaque	macaque
macaroni	macaroni
macaronies	macaronies
macaroon	macaroon
macaw	macaw
spikklubba/spira	mace
macerate	macerate
macerated	macerated
maceration	maceration
macerations	macerations
maces	maces
machete	machete
intrig	machination
machined	machined
machineries	machineries
maskiner	machinery
maskiner	machines
machinist	machinist
machinists	machinists
machismo	machismo
macho	macho
macrocephalic	macrocephalic
macrocosm	macrocosm
macroeconomics	macroeconomics
macroevolution	macroevolution
macroevolutionary	macroevolutionary
macroinstruction	macroinstruction
macromolecular	macromolecular
macromolecule	macromolecule
macromolecules	macromolecules
macropathological	macropathological
macropathology	macropathology
macrophage	macrophage
macrophages	macrophages
macrophagic	macrophagic
macroprocessor	macroprocessor
macroscopic	macroscopic
macrosimulation	macrosimulation
macrostructure	macrostructure
maculate	maculate
maculated	maculated
maculates	maculates
maculation	maculation
maculations	maculations
vansinnig	mad
vansinnig	mad
min fru/fröken	fru/frue
madams	madams
maddened	maddened
gjorda/gjort	gjorde
gjorda/gjort	gjorde
mademoiselle	mademoiselle
mademoiselles	mademoiselles
maestro	maestro
mafioso	mafioso
tidning	avis/tidskrift
magiskt	magic
trollkarl	magician
magicians	magicians
magistral	magistral
magistrally	magistrally
magistrature	magistrature
magma	magma
jag/mig	jeg/mig
mjöd/äng	mead
äng	eng
äng	eng
meadowland	meadowland
ängen	meadows
meager	mager/tynd
meagerly	meagerly
mager/torftig	meagre
mål	mel/måltid
meals	meals
mena/betyda/tarvlig	betyde
slingra sig	meander
meaningless	meaningless
betydelse	meanings
menas	værktøj
kött	kød
meats	meats
meatball	meatball
meatballs	meatballs
mekaniker	mechanical
mechanician	mechanician
mekanism	mechanism
mekanismer	mechanisms
medalj	medal
medaljong	medallion
medallions	medallions
mediatrice	mediatrice
mediatrix	mediatrix
medic	medic
medicinsk/läkar-	medicinsk
medically	medically
medicament	medicament
medicaments	medicaments
medicinal	medicinal
medicin	medicine
medicines	medicines
medico	medico
medicolegal	medicolegal
medics	medics
medeltida	medieval
medievalist	medievalist
medievalists	medievalists
medelmåttig	mediocre
mediocrity	mediocrity
planera/meditera	meditate
meditates	meditates
meditation	meditation
meditations	meditations
meditative	meditative
mellan	mellem
medlar	medlar
blandning/brokig	medley
medleys	medleys
medulla	medulla
medusae	medusae
ödmjuk	meek
meekly	meekly
meekness	meekness
meerschaum	meerschaum
megabyte	megabyte
megabytes	megabytes
megacycle	megacycle
megahertz	megahertz
megalith	megalith
megalithic	megalithic
megalomania	megalomania
megalomaniac	megalomaniac
megalomaniacal	megalomaniacal
megaphone	megaphone
melancholia	melancholia
melancholic	melancholic
melange	melange
melodic	melodic
melodies	melodies
melodious	melodious
melodrama	melodrama
melodramas	melodramas
melodramatic	melodramatic
melodi	melody
melon	melon
meloner	melons
melted	melted
medlem	medlem/tilhænger
medlemmars	members
membran	membrane
membranes	membranes
membranous	membranous
memoir	memoir
memoarer	memoirs
minnesvärd	memorable
minnen	hukommelser
memorera	memorize
memorerat	memorized
karlar	men
hot	true/trussel
menagerie	menagerie
menageries	menageries
menhir	menhir
meningitis	meningitis
meniscus	meniscus
menopause	menopause
menstrual	menstrual
menstruation	menstruation
menstruations	menstruations
sjäslig/sinnes-	mental
mentality	mentality
menthol	menthol
nämna	omtale
meny	spiseseddel
meow	meow
meowing	meowing
meows	meows
mephitic	mephitic
handels-/affärs-	mercantile
mercantilism	mercantilism
mercenaries	mercenaries
legosoldat	mercenary
köpman	købmand
köpmän	merchants
kvicksilver	mercury
barmhärtighet	barmhjertighed
meridian	meridian
meridional	meridional
förtjänst/förtjäna	fortjene
meritocracy	meritocracy
meriter	merits
sjöjungfru	mermaid
mermaids	mermaids
god	glædelig
meddelande	bekendtgørelse
meddelanden	meddelelser
messiahs	messiahs
messianska	messianic
stöna	moan
stönade	moaned
stönande	moaning
stönar	moans
vallgrav	moat
moats	moats
mob	mob
mock	mock
mocked	mocked
hån	mockery
modal	modal
månljus/månsken	moonlight
älg	moose
naiv	naive
naively	naively
naken	nøgen
namn/döpa	navn
namngiven	named
anonym	nameless
nämligen	nemlig
nämligen	nemlig
namn/döper	navner
nationell/riks-	fædrelandsk
nationalism	nationalism
nationalist	nationalist
infödd	native
naturlig	naturlig
naturalisera	naturalize
naturligtvis	naturligvis
neap	neap
i närheten	nær
närmare	nærmere
försumma	forsømme
neighbor	neighbor
neighbors	neighbors
nätverk	net
för nätverk	networked
nätverk	networks
nio	ni
nitton	nitten
nittonde	nineteenth
nineties	nineties
ninetieth	ninetieth
nittio	halvfems
ninetyfold	ninetyfold
ninth	niende
niobium	niobium
nypa/frostskada	nip
smörjkopp	nipple
nipplar	nipples
nips	nips
nirvana	nirvana
nitrat	nitrate
nitrated	nitrated
nitrates	nitrates
nitrating	nitrating
nitration	nitration
nitrations	nitrations
salpeter	nitric
nitrera	nitride
kväve	nitrogen
nitroglycerin	nitroglycerin
nitroglycerine	nitroglycerine
adlig/ädel	noble
adelsman	nobleman
noblemen	noblemen
nobleness	nobleness
ingen	nobody
noctambulism	noctambulism
noctambulist	noctambulist
nocturn	nocturn
nocturnally	nocturnally
nu	nå/nu
nu för tiden	nu for tiden/nu til dags
noway	noway
noway	noway
idiot	oaf
oafishness	oafishness
ek	eg
åra	åre
oarsman	oarsman
oas	oasis
havre	oat
ed/svordom	ed
havremjöl	oatmeal
förstockad	obdurate
lydnad	obedience
lydig	lydig
obelisk	obelisk
fet	obese
överdriven fetma/dästhet	obesity
ocean	ocean
en	en/et
apelsin	appelsin
oranges	oranges
kretslopp	orbit
orbital	orbital
orbits	orbits
orkester	orchestra
orchestral	orchestral
orchestras	orchestras
orchestrated	orchestrated
beställa/beställning	bestilling/befaling
beställd	ordered
organism	organism
organisms	organisms
organist	organist
organists	organists
organisation	organization
organisationer	organizations
organisera	organize
organiserad	organized
organ	organs
orgasm	orgasm
orgasmer	orgasms
orgies	orgies
orgie/utsvävning	orgy
orienten	orient
orientable	orientable
orientering	orientation
orientations	orientations
orienterad	orienteret
orients	orients
öppning	orifice
orifices	orifices
orificial	orificial
ursprung	oprindelse
original/ursprunglig	oprindelig
äkthet	originality
ursprunligen	originally
originals	originals
origins	origins
ornamental	ornamental
ornithology	ornithology
orthodox	orthodox
orthodoxes	orthodoxes
orthogonal	orthogonal
fart	træde/skridt
fart	træde/skridt
pachyderm	pachyderm
stilla	stille
pacifically	pacifically
pacification	pacification
pacifications	pacifications
pacificist	pacificist
pacifier	pacifier
pacifism	pacifism
pacifist	pacifist
lugna/stilla	pacify
lugna/stilla	pacify
paket	pakke/indpakke
paket	pakke/indpakke
packaged	packaged
packaged	packaged
packad	packed
litet paket	pakke
frakt	packing
fördrag	pact
pacts	pacts
kudde	blok
stoppning	padding
paddel/paddla	paddle
hästhage/sadelplats	paddock
hänglås	padlock
hänglås	padlock
padrone	padrone
paella	paella
hedning/hednisk	pagan
hedningar	pagans
festtåg	pageant
pageantry	pageantry
betalad	paid
hink	spand
smärta	smerte
pained	pained
smärtsam	smertelig
smärtsam	smertelig
smärtsamt	painfully
noggrann	painstaking
måla	farve/male
måla	farve/male
paintbrush	paintbrush
målare	maler
painters	painters
tavla/målning	billede
målar	paints
par	par
pyjamas	pajamas
vän	pal
vän	pal
palats	palace
smaklig	palatable
palaver	palaver
blek	bleg
färgkarta	palette
bårtäcke/äcklas	pall
brits/hård bädd	pallet
pallette	pallette
pallor	pallor
handflata	palm
handflata	palm
kännbar	palpable
kännbar	palpable
usel	paltry
broschyr	brochure
panna/kastrull/skål	pan
panacea	panacea
panama	panama
pancake	pancake
panda	panda
pandemonium	pandemonium
fönsterruta	pane
ruta/fält/panel	panel
paneling	paneling
panelling	panelling
smärta/styng	pang
få panik	panic
få panik	panic
panicky	panicky
panorama	panorama
pensé	pansy
flämta/flämtning	pant
panther	panther
trosor	underbukser
skafferi	spisekammer
byxor	bukser
papa	papa
papper/tidning	papir
pocketbok	brochure
parameter	parameter
passer	passer
lidelse/vrede	ild
passionerat	passionately
passiv	passive
passivity	passivity
lösenord	password
passwords	passwords
förbi	fortid/forbi
pasta	pasta
pectorals	pectorals
egendomlig	peculiar
ånger	penitence
penitences	penitences
penitency	penitency
ångerfull	penitent
pentadactyl	pentadactyl
pentadactylism	pentadactylism
pi	pi
pianist	pianist
pianistic	pianistic
bild	billede
bilder	pictures
tårt	pie
pies	pies
gris	svin
pigeonhole	afdeling
pigment	pigment
pigmentation	pigmentation
pigments	pigments
pigs	pigs
lots/lotsa/pilot	pilot
pilots	pilots
pilule	pilule
barrträd/tall/tyna/tyna bort	fyr
ananas	ananas
pineapples	pineapples
pines	pines
rosa	skær
fickan	lomme
plånbok	pocketbook
pocketbooks	pocketbooks
pockets	pockets
podium	podium
pogrom	pogrom
pogroms	pogroms
pekare	pointer
pointillism	pointillism
pointillist	pointillist
pointilliste	pointilliste
pointillistic	pointillistic
gift	forgifte/gift
giftig	giftig
poisonousness	poisonousness
poisons	poisons
polar	polar
polarities	polarities
polarity	polarity
polarize	polarize
polarized	polarized
polemical	polemical
polemically	polemically
polemicize	polemicize
polisen	politiet
polis	politibetjent
polis	politibetjent
polis	politibetjent
policemen	policemen
policemen	policemen
policemen	policemen
policewoman	policewoman
policewomen	policewomen
politik	politik
glans/polera/polska	polske
glans/polera/polska	polske
artig	høflig
politely	politely
artighet	høflighed
politisk	politisk
politiskt	politically
politiker	politician
politicians	politicians
politik	politik
polka	polka
förorenande ämne	pollutant
orena/förorena	pollute
polluted	polluted
polluter	polluter
miljöförstöring	pollution
polonium	polonium
poltergeist	poltergeist
polyandrous	polyandrous
polyandry	polyandry
hälla	øse/strø
tjura	pout
fattigdom	fattigdom
krut/pulver/puder	powder
powdery	powdery
kraft	kræft
kraftfull	powerful
powerless	powerless
powwow	powwow
practicability	practicability
genomförbar	practicable
praktisk	praktisk/virkelige
bedja	bede
bön	prayer
böner	prayers
praying	praying
praying	praying
predika	preach
predika	preach
preacher	preacher
preacher	preacher
preachers	preachers
preachers	preachers
predikanter	preaches
predikanter	preaches
preachify	preachify
predikandet	preaching
predikandet	preaching
predikandet	preaching
preachy	preachy
preachy	preachy
preamplifiers	preamplifiers
prearrange	prearrange
prearrange	prearrange
prince	prins
princedom	princedom
princely	princely
princes	princes
princess	prinsesse
huvudsaklig	principal
huvudsaklig	principal
principalities	principalities
furstendöme	principality
principally	principally
principally	principally
principals	principals
princip	princippet
principles	principles
skriva ut	trykke/tryk
skriva ut	trykke/tryk
skriva ut	trykke/tryk
utskriven	printed
skrivare	printer
skrivare	printer
priorities	priorities
priorities	priorities
prioritet	priority
bevisa	bevise
pulsera	pulse
pulverizable	pulverizable
pulverizables	pulverizables
pulverization	pulverization
pulverize	male
pulverized	pulverized
pulverizer	pulverizer
pulverizers	pulverizers
pulverizes	pulverizes
pulverizing	pulverizing
puma	puma
pump	pumpe/oppumpe
trycka	støde/stød
pushchair	pushchair
trycker/tryckande	pushing
placera/uttrycka	lægge/stille/sætte
putdown	putdown
putout	putout
putrefaction	putrefaction
vaktel/bäva/förlora modet	quail
quails	quails
skälva/skalv	quake
kvalitet	egenskab
oro/illamående	qualm
samvetskval	qualms
mängd	quantity
gräl	quarrel
byte/stenbrott	quarry
fjärdedel	quarter
quarterdeck	quarterdeck
quarterfinal	quarterfinal
drottningen	dame
underlig	queer
undertrycka/kuva	quell
släcka/undertrycka	quench
gnällig	querulous
förfrågan	query
sök/sökande	quest
fråga	spørgsmål
köa	queue
rida på ord/slingra sig	quibble
snabb	hurtig
quicklime	quicklime
snabbt	hurtigt
kvicksand	quicksand
quicksilver	kviksølv
tyst	rolig
quieten	quieten
tystlåtet	quietly
gåspenna	quill
sängtäcke	quilt
sarkasm/besynnerlighet/snirkel	quirk
sluta	quit
ganska	meget/særlig
kvot	quota
citat	citater
ange	citere/anførelsestegn
r	r
rabbet	rabbet
rabbi	rabbi
rabbinic	rabbinic
kanin	kanin
kaniner	rabbits
slödder	rabble
galen/arg	rabid
rabies	rabies
raccoon	raccoon
tävling/ras	race
tävlingshäst	racehorse
racemic	racemic
racer	racer
races	races
rachis	rachis
rachitic	rachitic
rachitis	rachitis
racialism	racialism
racialist	racialist
racialistic	racialistic
racing	racing
racism	racism
racist	racist
ställning	rack
oväsen/bedrägeri/racket	racket
oväsen/bedrägeri/racket	racket
radar	radar
radars	radars
radio	radio
läsa	læse
läsbarhet	readability
läsbar	readable
läsare	læsere
läsarna	læserne
readership	readership
readership	readership
gärna	readily
gärna	readily
gärna	readily
villighet	readiness
villighet	readiness
läser	læser
läser	læser
läser	læser
readings	readings
readings	readings
revidera	readjust
readjusts	readjusts
readjusts	readjusts
avläsning	readout
avläsning	readout
readouts	readouts
läser	reads
klar	færdig
klar	færdig
klar	færdig
på nytt bekräfta	reaffirm
på nytt bekräfta	reaffirm
reaffirms	reaffirms
reaffirms	reaffirms
reagent	reagent
riktig	virkelig
riktig	virkelig
riktig	virkelig
realisable	realisable
realism	realism
realist	realist
realistiskt	realistic
realistiskt	realistic
realistically	realistically
verkligheten	sandhed
förstå	forstå
verkligen	egentlig
reporter	reporter
representerar	forestille
begäran/efterfråga	bede/bøn
begäran/efterfråga	bede/bøn
begäran/efterfråga	bede/bøn
väg	vej
vägar	roads
roadwork	roadwork
rövare	robber
rotting	rotting
sabbat	sabbat
sabbat	sabbath
sabbatic	sabbatic
sabbats-	sabbatical
saber	saber
sabin	sabin
sobel	sable
sabot	sabot
sabotage/sabotera	sabotage
saboterad	sabotaged
sabotage	sabotages
sabotör	saboteur
sabra	sabra
sabras	sabras
saccade	saccade
sackarin	saccharin
sackarin	saccharine
saccharose	saccharose
sacerdotal	sacerdotal
sacerdotally	sacerdotally
portionspåse	sachet
säck/avskeda/plundra	afskedige
säck/avskeda/plundra	afskedige
sackcloth	sackcloth
sacked	sacked
sackful	sackful
sacks	sacks
sakrament	sacrament
sakramental	sacramental
sacraments	sacraments
sacre	sacre
helig	sacred
offer/uppoffring/uppoffra	ofre
uppoffrat	sacrificed
sacrifices	sacrifices
helgerån	sacrilege
ledsen	bedrøvet
göra ledsen	sadden
sadder	sadder
saddest	saddest
sadel	sadel
saddlebag	saddlebag
saddlebags	saddlebags
saddlebow	saddlebow
saddlecloth	saddlecloth
saddled	saddled
saddleless	saddleless
saddler	saddler
saddlery	saddlery
saddles	saddles
saddletree	saddletree
sadism	sadism
sadist	sadist
sadistiska	sadistic
sadistically	sadistically
sadists	sadists
ledsamt	sadly
sorg	sørg
safari	safari
säker	sikker
safecracker	safecracker
safecracking	safecracking
skydd/säkra	sikre
safeguarded	safeguarded
safeguards	safeguards
säkrare	safer
säkraste	safest
säkerhet	sikkerhed
safflower	safflower
saffron	saffron
bågna/sjunka	bugne
saga	saga
sagacious	intelligent/fornuftig
sagaciously	sagaciously
sagaciousness	sagaciousness
skarpsinne/klokhet	sagacity
vis/salvia	fornuftig
sagely	sagely
sago	sago
saguaro	saguaro
sahib	sahib
sa	sagde
segla	sejle/sejl
segla	sejle/sejl
sailable	sailable
sailboat	sailboat
sailboater	sailboater
sailcloth	sailcloth
sjömän	sailors
sails	sails
sainfoin	sainfoin
helgon/sankt/sankta	saint
sainted	sainted
sainthood	sainthood
saith	saith
skull	sags skyld
salability	salability
salacious	salacious
salad	salat
salads	salads
salamander	salamander
salaried	salaried
salaries	salaries
försäljning	salg
säljbar	saleable
saleroom	saleroom
salesclerk	salesclerk
salesgirl	salesgirl
saleslady	saleslady
försäljare	salesman
salesmanship	salesmanship
försäljare	salesmen
salespeople	salespeople
salesperson	salesperson
salesroom	salesroom
saleswoman	saleswoman
saleswomen	saleswomen
framträdande/utskjutande	salient
salthaltig/saltdamm	saline
salinity	salinity
salinometer	salinometer
salinometers	salinometers
saliva	saliva
salivary	salivary
salivate	salivate
salivated	salivated
salivates	salivates
salivating	salivating
salivation	salivation
sallies	sallies
gulblek/sälg	bleg
sallowish	sallowish
lax	laks
salmons	salmons
salon	aula
salons	salons
salt/salta	salt
saltwater	saltwater
saltworks	saltworks
saltwort	saltwort
salt	salty
hälsosam	salubrious
salubrity	salubrity
bärga/bärgning	salvage
silverbricka	salver
samba	samba
samma	samme
sampan	sampan
samphire	samphire
samurai	samurai
samurais	samurais
sand	sand
sandal	sandal
skola	skole
hav/sjö/sjögång	hav
sälja	sælge
säljare	seller
sellers	sellers
serendipity	serendipity
lugn/fridfull	serene
sju	syv
sevenfold	sevenfold
sjutton	sytten
seventeenth	seventeenth
seventh	syvende
seventies	seventies
seventieth	seventieth
seventy	halvfjers
seventyfold	seventyfold
hugga av/skilja	sever
kännbara/stränga	severe
severed	severed
kännbart	severely
severities	severities
stränghet	severity
avloppsvatten	sewage
kön	køn
sexagenarian	sexagenarian
sexuell	sexual
sexuellt	sexually
nyanser	nuancer
skugga	skygge
skuggor	shadows
shagreen	shagreen
shah	shah
skaka	ryste
shakedown	shakedown
shaken	shaken
skakande/skral/svag	shaky
shaman	shaman
shamanism	shamanism
shampoo	shampoo
shampoos	shampoos
får	får
sheepherder	sheepherder
skepp	skib
skepp	skib
skit	lort
sjukt	syg
silver	sølv
sjunga	synge
sångare	sanger
sjunka	synke/sænke
sex	seks
sexton	sejsten
sixteenth	sixteenth
sixties	sixties
sextio	tres
sixtyfold	sixtyfold
storlek	størrelse
skridsko/åka skridsko	skøjte
skateboard	skateboard
skateboarder	skateboarder
skateboarding	skateboarding
skateboards	skateboards
skater	skater
skaters	skaters
skates	skates
skating	skating
skicklighet	skill
skicklig/yrkesutbildad	skilled
skilless	skilless
skicklig	skillful
himmel	himmel
lärka	skylark
skyscraper	skyscraper
tryne	snout
snö	sne
snowball	snowball
snöflinga	snowflake
snögubbe	snowman
snowstorm	snowstorm
programvara	software
sorrily	sorrily
sorg	sorrow
sortera	art
sorterad	sorted
sorter	sorter
själ	sjæl
spectra	spectra
spectrum	spectrum
spekulera	speculate
spekulation	speculation
stapelvara/krampa/märla	staple
stapled	stapled
stapler	stapler
staplers	staplers
staples	staples
stjärna	stjerne
stjärnor	stjerner
starta	begynde/begyndelse
stifled	stifled
styrka	kraft
dum	dum
ämne	emne
lyckas/efterträda	lykkes
framgång	succes
sol	sol
sunbathe	sunbathe
sunny	sunny
undertryckt	suppressed
misstänka	suspect
svär	bande/sværge
lapp/etikett	tab
lapp/etikett	tab
tabernakel	tabernacle
bord	bord
tablå	tableau
tableaus	tableaus
tableaux	tableaux
bordsduk	tablecloth
tablecloths	tablecloths
tabeller	tables
skrivblock	tablet
lertavlor	tablets
taboos	taboos
tachometer	tachometer
tachometers	tachometers
tyst/underförstådd	tacit
svans	hale
skräddare	skrædder
tailored	tailored
tailors	tailors
svansar	tails
uppgift	opgave
uppgifter	tasks
smaka	smage/smag
smakade	tasted
smaklös	tasteless
riva sönder	rive itu/tåre
riva sönder	rive itu/tåre
riva sönder	rive itu/tåre
riva sönder	rive itu/tåre
teardrop	teardrop
tearful	tearful
tearfully	tearfully
tearfully	tearfully
teargas	teargas
tearjerker	tearjerker
tearless	tearless
tearless	tearless
tearoom	tearoom
tårar	tears
tårar	tears
tearstained	tearstained
tearstained	tearstained
reta/retas	tease
reta/retas	tease
reta/retas	tease
teasel	teasel
svår uppgift	teaser
svår uppgift	teaser
teases	teases
teases	teases
teases	teases
teasing	teasing
teasing	teasing
teasingly	teasingly
teasingly	teasingly
teaspoon	teaspoon
teaspoon	teaspoon
teaspoonful	teaspoonful
spene	teat
spene	teat
spene	teat
spene	teat
teatime	teatime
teats	teats
teats	teats
tio	ti
tendencies	tendencies
benägenhet/tendens	tendens
tenderfoot	tenderfoot
ömt	tenderly
thence	derfra
thence	derfra
thenceforth	thenceforth
thenceforward	thenceforward
theocracy	theocracy
theocratic	theocratic
theodolite	theodolite
teolog	theologian
teologer	theologians
theological	theological
theologically	theologically
teologi	theology
theorem	theorem
theorems	theorems
teoretisk	theoretical
teoretisk	theoretical
theoretically	theoretically
theoretician	theoretician
theoretician	theoretician
theoreticians	theoreticians
theoreticians	theoreticians
theorist	theorist
theorist	theorist
theorists	theorists
theorists	theorists
theorize	theorize
tjuv	tyv
fastän	though
fastän	though
tänkte	tanke
tänkte	tanke
tankfull	thoughtful
thoughtfully	thoughtfully
thoughtfulness	thoughtfulness
thoughtless	thoughtless
thoughtlessly	thoughtlessly
thoughtlessness	thoughtlessness
tusental	tusinde
thousandth	thousandth
klå/tröska	thrash
klå/tröska	thrash
tråd	tråd
tråd	tråd
tråd	tråd
trådsliten/banal	threadbare
hot	trussel
hota	1
threatening	threatening
threateningly	threateningly
tre	tre
tigress	tigress
idag	i dag
tå	tå
tradition	tradition
traditionell	traditional
spår	trail
tåg/träna	tog
trainee	trainee
tränare	trainer
förrädare	traitor
transaktion	transaction
transalpine	transalpine
transcribe	transcribe
överföring	transfer
översätta	oversætte
översättning	oversættelse
översättare	translator
sända	sende
träd	træ
lastbil/transportera	lastvogn
två	to
allestädes närvarande	ubiquitous
ubiquity	ubiquity
juver	yver
usch	ugh
uglier	uglier
ugliest	ugliest
uglify	uglify
uglily	uglily
fulhet	ugliness
otäckt	grim
ukulele	ukulele
varigt sår/böld	ulcer
ulcerate	ulcerate
ulcerated	ulcerated
ulceration	ulceration
ulcerative	ulcerative
ulna	ulna
ultimo	ultimo
arbetslöshet	arbejdsløshed
ledigt	vacant
utrymma	vacate
semester	ferie
vaccinera	vaccinate
vaccinated	vaccinated
tomrum	vacuum
vacuumed	vacuumed
slida	vagina
luffare	vagrant
vag/svävande	vague
fåfäng	forfængelig
wacky	wacky
vagga/vifta	wag
valnöt	valnød
magasin	warehouse
magasin	warehouse
warehouses	warehouses
tvätta	vaske
gråta	græde
gråt	weeping
gråt	weeping
weeps	weeps
gråtmild	weepy
gråtmild	weepy
vivel	weevil
inslag i väv	weft
väga	veje
väga	veje
weighing	weighing
weighings	weighings
väger	weighs
vikt	vægt
weighted	weighted
weighted	weighted
weightily	weightily
weighting	weighting
weighting	weighting
weightless	weightless
weightlessness	weightlessness
belastningar	belastninger
belastningar	belastninger
tung	weighty
tung	weighty
fördämning/damm	weir
konstig	weird
weirdie	weirdie
weirdies	weirdies
weirdly	weirdly
weirdness	weirdness
weirdness	weirdness
weirdo	weirdo
weirdos	weirdos
weirs	weirs
välkommen	welcome
välkommen	welcome
välkommen	welcome
välkommen	welcome
var	hvor
fönster	vindue
fönster	vindue
windowpane	windowpane
windowpanes	windowpanes
windows	windows
windstorm	windstorm
vin	vin
vinglas	wineglass
winegrower	winegrower
winemaker	winemaker
winemaking	winemaking
winepress	winepress
wines	wines
winey	winey
vinge/flygel/eskader	vinge
winglet	winglet
blinka	wink
vinter	vinter
torka	wipe
tråd/telegram/telegrafera	tråd
tråd/telegram/telegrafera	tråd
tråd/telegram/telegrafera	tråd
wired	wired
trådlös/radio	wireless
kabeldragning	wiring
senig/seg	wiry
klokhet	wisdom
klokt	fornuftig
kvickhet/kvickhuvud	wisecrack
klokt	wisely
wiser	wiser
önskar	ønske/ville/vilje
önskar	ønske/ville/vilje
wishbone	wishbone
önskar	wishes
wishful	wishful
häxa	witch
witches	witches
med	med
dra tillbaka	withdraw
dra tillbaka	withdraw
utan	udder
bevittna	witness
bevittna	witness
vittnen	witnesses
järv	wolverine
järv	wolverine
värld	verden
världsomspännande	worldwide
främlingsskräck	xenophobe
främlingsskräck	xenophobia
xenophobic	xenophobic
xerographic	xerographic
xylem	xylem
xylene	xylene
xylophone	xylophone
xylophones	xylophones
xylophonist	xylophonist
xylose	xylose
xylotomic	xylotomic
lustjakt	yacht
segling	yachting
seglare	yachtsman
jak	yak
jams	yam
gläfsa	yap
gård	gård
tumstock	yardstick
garn/skepparhistoria	yarn
gäspa	gabe
gäspa	gabe
gäspande	yawning
ja	yeah
år	år
årsbok	yearbook
yearlong	yearlong
årlig/årligen	årlig
årlig/årligen	årlig
längta	yearn
längtande	yearning
yearningly	yearningly
år	years
jäst	yeast
vråla	yell
vråla	yell
gul	gul
yellowed	yellowed
yellowing	yellowing
yellowish	yellowish
ja	ja
igår	i går
ännu	endnu/allerede
idegran	yew
avkastning/vika sig	give efter
yoga	yoga
yoghurt	yoghurt
yogurt	yogurt
ok	yoke
äggula	yolk
du/ni	du/dig/dem/jer
du/ni	du/dig/dem/jer
ung	ung
yngre	younger
pojkspoling	youngster
ungdom	ungdom
ungdomlig	youthful
yuppie	yuppie
zabaglione	zabaglione
dumbom	zany
zazen	zazen
iver/nit	iver
ivrig/nitisk	zealous
sebra	zebra
zenith	zenith
noll	nol
noll	nol
krydda/aptit	zest
sicksack	zigzag
zink	zinc
blixtlås	zipper
zodiac	zodiac
zodiac	zodiac
zon/bälte	zone
zon/bälte	zone
zoologisk trädgård	zoo
zoologi	zoology
zoom	zoom
zucchini	zucchini
