en/ett	ein
en/ett	ein
jordsvin	aardvark
jordsvin	aardvark
aardvarks	aardvarks
bakåt	zurück
bakåt	zurück
bakåt	zurück
abacterial	abacterial
kulram	abacus
kulram	abacus
kulram	abacus
abacuses	abacuses
abacuses	abacuses
abacuses	abacuses
akter ut	abaft
abalone	abalone
abalones	abalones
överge	ablassen
överge	ablassen
övergiven/övergivna	impertinent
övergiven/övergivna	impertinent
övergiven/övergivna	impertinent
abandonee	abandonee
abandoner	abandoner
abandoning	abandoning
uppgivenhet	zession
uppgivenhet	zession
abandonments	abandonments
förnedra	demütigen
abased	abased
förnedring	abasement
abasements	abasements
abases	abases
göra generad	beschämen
generad	verlegen
generad	verlegen
abasing	abasing
minska/lindra	erschlaffen
minska/lindra	erschlaffen
abated	abated
avtagande	nachlaß
avtagande	nachlaß
abatements	abatements
abates	abates
abating	abating
abating	abating
slakthus	abattoir
abbe	abbe
abberations	abberations
kloster	abtei
kloster	abtei
abbeys	abbeys
abbot	abt
abbot	abt
abbot	abt
abbot	abt
abbot	abt
abbotar	abbots
förkorta	abkürzen
förkorta	abkürzen
abbreviated	abbreviated
abbreviates	abbreviates
abbreviating	abbreviating
förkortning	verkürzung
förkortning	verkürzung
förkortning	verkürzung
förkortningar	verkürzungen
förkortningar	verkürzungen
abbreviator	abbreviator
abdicable	abdicable
avsäga sig	abdanken
avsäga sig	abdanken
abdicated	abdicated
avsägelse	abdication
abdicator	abdicator
kropp	hinterleib
kropp	hinterleib
abdomens	abdomens
buk-	den unterbauch betreffend
abdominally	abdominally
bortföra	abduct
abducted	abducted
abducting	abducting
bortrövande	abduction
abductions	abductions
kidnappare	abductor
abductors	abductors
tvärs	quer
alfabetisk	abecedarian
till sängs	abed
avvikelse	abweichung
som far vilse	aberrant
aberrantly	aberrantly
villfarelse	aberration
villfarelse	aberration
aberrations	aberrations
underblåsa	agitieren
medhjälp	mithilfe
abets	abets
abetted	abetted
abetter	abetter
abetting	abetting
medhjälpare	abettor
vila	ruhen
abeyant	abeyant
avsky	verabscheuen
abhorred	abhorred
avsky	abscheu
motbjudande	abhorrent
abhorrently	abhorrently
abhorring	abhorring
abhors	abhors
stanna/vänta	gewärtigen
abided	abided
abides	abides
bestående/varaktig	fest
själsgåvor	abilities
möjlighet	kapazität
möjlighet	kapazität
abiotic	abiotic
föraktlig	gemein
uselhet	abjection
abjectly	abjectly
avsvärjande	abjuration
avsvärja	annullieren
abjurer	abjurer
borttagande	ablation
ablativ	ablativ
i lågor	ablaze
i lågor	ablaze
kunna	begabt
kunna	begabt
kunna	begabt
kunna	begabt
abler	abler
ablest	ablest
i blom	abloom
tvätta sig	ablution
tvagning	ablutions
skicklig/duktigt/kunnigt	ably
avsäga sig	abnegate
abnegates	abnegates
förnekelse	aufopferung
avvikande	abnormal
avvikande	abnormal
avvikande	abnormal
abnormalities	abnormalities
abnormitet	abnormalität
onormalt	abnormally
ombord	an bord
boning/vistelse	wohnort
abodes	abodes
kokande	aboil
avskaffa	annullieren
avskaffa	annullieren
abolishable	abolishable
avskaffade	abolished
abolisher	abolisher
abolishes	abolishes
abolishment	abolishment
avskaffande	abolition
avskaffande	abolition
abolitionism	abolitionism
förkämpe	abolitionist
abolitionists	abolitionists
avskyvärd	abscheulich
abominably	abominably
avsky	verabscheuen
avsky	abscheu
abominations	abominations
urinvånare	eingeboren
aboriginally	aboriginally
urinvånare	aborigine
aborigines	aborigines
abort	abortieren
avbrutits	aborted
aborter	aborter
aborting	aborting
missfall/abort	fiasko
missfall/abort	fiasko
abortör	abortionist
abortionists	abortionists
abortions	abortions
misslyckad	nutzlos
abortively	abortively
aborts	aborts
överflöda av	schwärmen
om/cirka	betreffs
ovan	oberhalb
aboveboard	aboveboard
aboveground	aboveground
abovementioned	abovementioned
abovementioned	abovementioned
abrakadabra	abracadabra
abradable	abradable
skava av	hobeln
avskavning/slitning	abrasion
abrasions	abrasions
sträv	grell
abrasives	abrasives
jämsides	abreast
förkorta	begrenzen
abridged	abridged
förkortning/sammandrag	übersicht
abridging	abridging
utomlands	äußerlich
avskaffa	annullieren
abrogated	abrogated
abrogation	abrogation
hastig	abgerissen
abrupt	abruptly
abruptness	abruptness
böld	abszeß
abscesses	abscesses
rymma	ausreißen
absconded	absconded
frånvaro	abwesenheit
absences	absences
frånvarande	abwesend
frånvarande	abwesend
skolk	absenteeism
absentees	absentees
frånvarande	abwesend
absentminded	absentminded
absentmindedly	absentmindedly
absentmindedly	absentmindedly
absentmindedness	absentmindedness
absinth	beifuß
absinthe	beifuß
absolut	absolut
absolut	freilich
frikännande	begnadigung
envälde	absolutismus
frikänna	absolvieren
absolved	absolved
absolving	absolving
uppta	absorbieren
absorbability	absorbability
absorbable	absorbable
absorbant	absorbant
ingick i	absorbed
absorberande	absorbent
absorberande	absorbing
absorbering	absorption
avstå	abstain
abstained	abstained
återhållsam	abstinent
röstnedläggelse	abstinenz
abstentions	abstentions
röstnedläggelse/återhållsamhet	abstinenz
måttlig	abstinent
abstinently	abstinently
abstrakt	abstrakt
abstrakt	abstrakt
abstraktion	diebstahl
dunkel	geheimnissvoll
orimlig	abgeschmackt
absurdism	absurdism
absurdist	absurdist
absurdities	absurdities
orimlighet	verdrehtheit
överflöd	reichtum
överflödande	reichlich
abundantly	im überfluß
missbruk	beleidigen
missbrukat	abused
ovettig/smädlig	anzüglich
abusively	abusively
gränsa intill	abut
abuzz	abuzz
bottenlös	unerforschlich
abysmally	abysmally
avgrund	abgrund
avgrund	abgrund
abysses	abysses
abysses	abysses
akacia	akazie
akademisk	student
akademisk	academical
akademiskt	academically
akademimedlem	academician
academies	academies
academism	academism
akademi	akademie
acanthus	akanthus
acanthuses	acanthuses
tillträda/biträda	beipflichten
tillträda/biträda	beipflichten
accelerera	beeilen
accelererade	accelerated
acceleration	acceleration
accelerations	accelerations
gaspedal	accelerator
accelerators	accelerators
accelerometer	accelerometer
accelerometers	accelerometers
tonvikt	accent
betonade	betonte
betonade	betonte
accents	accents
accentual	accentual
accentually	accentually
betona	betonen
accentuated	accentuated
betoning	accentuation
acceptera	annehmen
godtagbarhet	acceptability
godtagbart	acceptable
acceptabelt	acceptably
accepterande	annahme
accepterad	accepted
accepter	accepter
acceptant	acceptor
tillgång	anfall
åtkomliga	accessed
accessibility	accessibility
åtkomlig	zugänglich
tillträde/tillskott	errungenschaft
accessorial	accessorial
tillbehör	zubehör
accessorize	accessorize
accessors	accessors
tillbehör	accessory
olycka	unfall
tillfällig	zufällig
accidentalism	accidentalism
accidentalist	accidentalist
händelsevis	accidentally
accidently	accidently
olyckor	accidents
hylla/hälsa såsom	akklamieren
bifallsrop	beifall
acclimate	acclimate
acclimated	acclimated
anpassa	akklimatisieren
dubbning till riddare	accolade
accolades	accolades
anpassa	adaptieren
anpassad	accommodated
tillmötesgående	entgegenkommend
anpassning	einrichtung
accommodations	accommodations
accompanied	accompanied
accompanier	accompanier
accompanies	accompanies
ackompanjemang	geleit
accompaniments	accompaniments
ackompanjatör	gefährte
accompanists	accompanists
ackompanjera	begleiten
accompanyist	accompanyist
accompanyists	accompanyists
medbrottsling	accomplice
accomplices	accomplices
utföra	erlangen
presterade	accomplished
prestation	accomplishment
accomplishments	accomplishments
bevilja/medge	akkord
enlighet	accordance
accorder	accorder
accorders	accorders
dragspel	ziehharmonika
accordionist	accordionist
accordionists	accordionists
accordions	accordions
accords	accords
tilltala	ansprechen
beräkning	konto
ansvarighet	accountability
ansvarig/förklarlig	accountable
bokförare	buchrevisor
bokföring	buchführung
accouterment	accouterment
accrued	accrued
accruement	accruement
samlat	accumulated
acetaminophen	acetaminophen
acetify	acetify
aceton	acetone
sur	herb
acidic	acidic
allergen	allergen
allergen	allergen
allergisk	allergic
allergier	allergies
allergier	allergies
allergi	allergie
allergi	allergie
mildra	alleviate
lätta	alleviated
gränd	gasse
gränd	gasse
alleys	alleys
alleys	alleys
förbindelse	verbindlichkeit
förbindelse	verbindlichkeit
alliances	alliances
alliances	alliances
allierad	allied
allierad	allied
alligator	alligator
alligator	alligator
alligators	alligators
alligators	alligators
alliteration	alliteration
alliteration	alliteration
alliterations	alliterations
alliterations	alliterations
tilldela	allocate
tilldelat	allocated
tilldelning	allocation
tilldelning	allocation
tilldelningen	allocations
allocution	allocution
allocution	allocution
allocution	allocution
fördela	verlosen
tillåta	lassen
tillåtna	zulässig
tillstånd	erlaubnis
tillåten	erlaubt
legering	legierung
alfabete	alphabet
alfabetisk	alphabetic
alfabetisk	alphabetical
alphabetization	alphabetization
alphabetizations	alphabetizations
alphabetize	alphabetize
alphabetized	alphabetized
alphabetizing	alphabetizing
alfabeten	alphabets
alphamerical	alphamerical
alfanumerisk	alphanumerisch
alphanumerical	alphanumerical
alphanumerically	alphanumerically
alphanumerics	alphanumerics
alpin	alpine
alpinism	alpinism
alpinist	alpinist
redan	bereits
även	auch
gräl	altercation
altercations	altercations
växla	sich ablösen
alternated	alternated
alternativt	alternately
bland	unter
amoralisk	amoral
kärleksfull	amorous
amorously	amorously
formlös	amorph
summa	anzahl
summa	anzahl
ampere	amp
ampere	ampère
ampersand	ampersand
amfetamin	amphetamine
och	und
hursomhelst	anyway
varsomhelst	irgendwo
aorta	aorta
snabbt	schnell
isär	abgesondert
apartheid	apartheid
lägenhet	appartement
apatisk	indolent
apati	apathie
människoapa	affe
människoapa	affe
aperitif	aperitif
öppning	öffnung
spets	spitze
aphid	aphid
anländer	eintreffen
aspen	espe
granska/revidera	kontrollieren
mötessal	auditorium
auditoriums	auditoriums
audits	audits
tillgänglig	verfügbar
pladdra/sorl	quasseln
pratmakare	babbler
babies	babies
babian	pavian
barn	kinder
kandidatexamen	baccalaureate
baccarat	baccarat
ungkarl	hagestolz
ungkarlar	bachelors
bacilli	bacilli
bacill	bacillus
tillbaka	rücken
ryggsmärtor	backache
baktala	backbite
ryggrad	wirbelsäule
bakgrund	hintergrund
backgrounds	backgrounds
bak	after
återfalla	backslide
ta kopia	backup
bakåt	backward
sidfläsk	speck
bakterie	bakterien
dålig	böse
emblem	insignien
badged	badged
badgers	badgers
raljeri	badinage
väska	beutel
bagatell	lapalie
bagatelles	bagatelles
bagage	bagage
påsar	bags
list	baguette
bah	bah
borgen	bail
agn	köder
baka	backen
bagare	bäcker
bakeries	bakeries
bakers	bakers
bageri	bäckerei
bakeshop	bakeshop
balans	saldo
balconies	balconies
balkong	altan
skallig/kal	kahlköpfig
baldhead	baldhead
rakt på sak	baldly
skallighet	baldness
bal/packe	bale
valfiskben	baleen
hindra	hindern
boll/kula	ball
visa	ballade
ballad	ballade
ballader	ballads
barlast	ballast
balett	ballett
balletic	balletic
ballong	ärostat
valsedel/sluten omröstning	ballot
ballar/bollar	balls
ballyhoo	ballyhoo
balsam	balsam
bambu	bambus
lura	betrügen
banan	banane
bananas	bananas
musikkår	bande
bandage	bandage
hårband	bandeau
bandit	bandit
bandits	bandits
bandleader	bandleader
kapellmästare	bandmaster
fördärv	bane
fördriven	banished
hulling	barb
barbar	barbar
barbarer	barbarians
barbarismen	barbarismus
frisör	barbier
barflicka	barmaid
bartender	barman
kaserner	kaserne
stranden	strand
bära	aushalten
bära	aushalten
säng	beet
sovrum	schlafzimmer
tro	glauben
förråda	verraten
bibliographic	bibliographic
bibliografier	bibliographies
källförteckning	bibliographie
björnbär	brombeere
bok	buch
boomerang	boomerang
boxer	boxer
pojke	junge
pojkar	boys
hjärna	gehirn
kull/yngel/ruva/grubbla	brood
kvast/ginst	besen
buljong/köttsoppa	broth
bygga	bauen
byggnad	anbau
hejdå	adieu
droska/förarhytt	droschke
kabal	cabal
cabala	cabala
cabalism	cabalism
cabalist	cabalist
cabalistic	cabalistic
caballero	caballero
krog	cabaret
kål	kohl
cabbages	cabbages
cabdriver	cabdriver
hytt	hütte
skåp/kabinett	kabinett
cabinetmaker	cabinetmaker
cabinetmakers	cabinetmakers
cabinets	cabinets
hytter	cabins
kabel	kabel
cabled	cabled
cablegram	cablegram
cablegrams	cablegrams
kablar	cables
cabling	cabling
chaufför	chauffeur
kabyss	caboose
kustfart	cabotage
cabriolet	cabriolet
cabs	cabs
kakao	cacao
cacciatore	cacciatore
kaskelot	cachalot
gömställe	cache
cachepot	cachepot
caches	caches
kackel/kackla/prat/fnitter	cackle
cackled	cackled
cackles	cackles
cackling	cackling
missljud	cacophony
cacti	cacti
kaktus	kaktus
lymmel	cad
cadaver	kadaver
cadaverous	cadaverous
caddies	caddies
teburk	caddy
cadence	cadence
yngre son/kadett	cadet
cadetship	cadetship
cadge	cadge
cadger	cadger
cafe	cafe
cafes	cafes
cafeteria	cafeteria
cafeterias	cafeterias
caffeine	caffeine
caftan	kaftan
bur	bauer
burar	cages
cahier	cahier
röse	cairn
cairns	cairns
caitiff	caitiff
smickra	cajole
cajoler	cajoler
mild övertalning	cajolery
tårta/bakelse/kaka	kuchen
tårta/bakelse/kaka	kuchen
kalcium	kalcium
beräkna	erachten
beräknad	calculated
kalibrera	calibrieren
calibrated	calibrated
calibration	calibration
bil	auto
carbonization	carbonization
carbonize	carbonize
carbonized	carbonized
carbonless	carbonless
carburetor	carburetor
carburetors	carburetors
carburization	carburization
carburize	carburize
kort	karte
cardamom	cardamom
cardiac	cardiac
kofta/stickad ylleväst	cardigan
cardioid	cardioid
cardioids	cardioids
varsamhet	sorge tragen
varsamhet	sorge tragen
cared	cared
karriär	karriere
försiktig	bedächtig
noggrannt	sorgfältig
katt	katze
cell	karzer
cellular	cellular
chans	zufällig
cherries	die kirschen
kyrkan	kirche
kyrkorna	churches
kappa	mantel
cloaks	cloaks
klocka	uhr
clockmaker	clockmaker
medsols	clockwise
pelargång/kloster	cloister
klon	clone
moln	wolke
clouds	clouds
kol	kohle
dator	computer
datorer	computers
kamrater	comrades
hemliga	concealed
conjuring	conjuring
begrunda/ha för avsikt	contemplate
begrunda/ha för avsikt	contemplate
begrunda/ha för avsikt	contemplate
contemplates	contemplates
contemplation	contemplation
contemplation	contemplation
contemplation	contemplation
contemplations	contemplations
contemplations	contemplations
contemplative	contemplative
contemporaneous	contemporaneous
contemporaneously	contemporaneously
contemporaries	contemporaries
contemporaries	contemporaries
samtidig/samtida/jämnårig	zeitgenössisch
samtidig/samtida/jämnårig	zeitgenössisch
förakt	verachtung
förakt	verachtung
contemptible	contemptible
contemptibly	contemptibly
föraktfull/hånfull	contemptuous
föraktfull/hånfull	contemptuous
contemptuously	contemptuously
contemptuously	contemptuously
strida/tävla/påstå	contend
strida/tävla/påstå	contend
strida/tävla/påstå	contend
contender	contender
contender	contender
contender	contender
contenders	contenders
contenders	contenders
contenders	contenders
contending	contending
contending	contending
contends	contends
contends	contends
innehåll	inhalt
innehåll	inhalt
innehåll	inhalt
tillfredsställd	zufrieden
tillfredsställd	zufrieden
contentedly	contentedly
contentedness	contentedness
contention	contention
contention	contention
contention	contention
contentions	contentions
contentions	contentions
contentions	contentions
contentious	contentious
contentious	contentious
belåtenhet	contentment
innehåll	inhalt
innehåll	inhalt
strid/bestrida/tävlan	konkurrenz-prüfung
strid/bestrida/tävlan	konkurrenz-prüfung
strid/bestrida/tävlan	konkurrenz-prüfung
contestant	contestant
contestant	contestant
babysång/vagga/barnsäng	kinderbett
coterie	coterie
cotillion	cotillion
cotillon	cotillon
villa/stuga	häuschen
cottager	cottager
soffa	couch
hosta	husten
coughs	coughs
räkna	rechne
ansikte	angesicht
motverka	counteract
counterbalance	counterbalance
countermand	countermand
countermarch	countermarch
counterplot	counterplot
kontrapunkt	counterpoint
counterpoise	counterpoise
counterweight	counterweight
grevinna	countess
oräkneliga	zahllos
land	gefilde
landsman/lantman	countryman
countrywide	countrywide
grevskap/län	county
par	ehepaar
verspar	couplet
kupong	coupon
mod	mut
modig	beherzt
courageously	courageously
kurir/löpare	courier
kurs/bana	kurs
springare/harjägare	courser
domstol	den hof machen
hövlig	artig
courteously	courteously
courteousness	courteousness
artighet	courtesy
courthouse	courthouse
hovman	courtier
courtliness	courtliness
elegant/artig	courtly
courtmartial	courtmartial
courtroom	gericht
courtship	courtship
kusin	base
bukt	cove
avtal/förbund	vereinbarungen
täcka	einband
hemlig/gömställe	covert
eftertrakta	gelüsten
covetous	covetous
covetously	covetously
ko	kuh
ko	kuh
feg/stackare	coward
feghet	cowardice
cowardly	cowardly
krypa ihop	kauern
cowherd	cowherd
huva/rökhuv	kappe
sprätt	coxcomb
blyg/pryd	coy
coyly	coyly
coyness	coyness
prärievarg	coyote
cozily	cozily
cozy	cozy
crabapple	crabapple
crabbed	crabbed
spricka upp	spalte
smällkaramell/knäckare	cracker
spraka	knistern
vagga	wiege
hantverk/fartyg/flygplan	craft
craftily	craftily
brant klippa/klippspets	crag
stoppa/packa	cram
kramp/hindra	cramp
tranbär	cranberry
trana/lyftkran	kranich
cranium	cranium
crankiness	crankiness
cranky	cranky
crape	crape
krascha	crash
packkorg/spjällåda	crate
crater	crater
be om/längta efter	crave
feg	feig
kravla	kriechen
kräfta	krebs
färgkrita	buntstift
mani	wut
crazily	crazily
tokiga	irre
knarra	fletschen
grädde	rahm
creamy	creamy
veck/rynka	zerknittern
skapa	schaffen
skapelse	creation
skapare	creator
varelse	gebilde
tilltro	credence
credential	credential
kredit	kredit
creditable	creditable
creditably	creditably
borgenär/fordringsägare	gläubiger
credo	credo
credulity	credulity
godtrogen	leichtgläubig
credulously	credulously
trosbekännelse	creed
liten vik/bukt	creek
krypa/smyga	kriechen
kryper	creeps
bränna	brennen
klipp	mähen
söt	süss
söt	süss
cuteness	cuteness
cutoffs	cutoffs
cutout	cutout
klipper	schneidet
kniv/tillskärare	cutter
sågning	cutting
cyanate	cyanate
cyanid	cyanide
cybernetic	cybernetic
cybernetician	cybernetician
cybernetics	cybernetics
cykel	fahrrad
cyclic	cyclic
konjunkturbetingad	cyclical
cyclist	cyclist
cyklister	cyclists
cycloid	cycloid
cycloidal	cycloidal
cyclone	wirbelwind
cyclonic	cyclonic
cyclopean	cyclopean
cyclotron	cyclotron
cylinder	walze
pappa	väterchen
daddies	daddies
pappa	väterchen
dads	dads
tokig	verrückt
tokig	verrückt
dolk	dolch
dahlia	dahlia
dahlias	dahlias
daglig	täglich
daintier	daintier
utsökt/fin	delikat
mejeri/mjölkbutik	milchgeschäft
dalmatisk	dalmatian
dalmatians	dalmatians
damm/dämma upp/djurmoder	gehege
skada	beschädigen
skada	beschädigen
skada	beschädigen
skada	beschädigen
skadade	damaged
skadade	damaged
damager	damager
damagers	damagers
skador	schäden
damaging	damaging
dame	dame
dammit	dammit
fördömelse	damnation
förbaskade	damned
fuktig	feucht
bli fuktig	dampen
dampened	dampened
dampness	dampness
dams	dams
dansa	ball
dansör/dansös	der tänzer
dansare	dancers
dansande	dancing
maskros	hundebluhme
dandelions	dandelions
dandies	dandies
mjäll	dandruff
fara	gefahr
farliga	besorglich
pil/rusa	dart
dag	tag
gryning	tagesanbruch
dagsljus	daylight
dagar	tagen
avaktivera	deactivate
deactivation	deactivation
död	sterblich
döv	taub
dödens	deaths
djup	tief
densitet	dichte
förtjäna	verdienen
detat	detat
detre	detre
tillbehör	apparat
tillbehör	apparat
dictated	dictated
dikterar	dictates
diktamen/diktat/maktbud	dictation
dictations	dictations
ordböcker	wörterbücher
lexikon	wörterbuch
gjorde	machte
dö	sterben
dött	died
disel	diesel
kost	diät
dietetically	dietetically
diets	diets
annorlunda/olika	verschieden
svårigheter	schwierigkeiten
svårighet	schwierigkeit
gräva/grävde/grävt	ausgraben
digested	digested
dignitaries	dignitaries
dignities	dignities
värdighet	würde
utvidga	erweitern
dilated	dilated
doktor	doktor
doeuvre	doeuvre
hund	hund
doggie	doggie
hundar	dogs
dricka	saufen
drinkar	drinks
köra/enhet	anfeuern
duggregn	drizzle
torr	trocken
anka/and/ducka	ente
varje	jede
örn	adler
örnar	eagles
eaglet	eaglet
öra	ohr
earache	earache
eardrum	eardrum
eardrums	eardrums
earlobe	earlobe
tidig	früh
förtjäna	erringen
earning	earning
earphones	earphones
earring	earring
earrings	ohrring
öron	ohren
jorden	boden
jordbävning	erdbeben
jordbävningar	earthquakes
earths	earths
daggmask	regenwurm
earthworms	earthworms
earwax	earwax
lätthet	ease
staffli	arbeitsbock
lättare	easier
lättaste	leichteste
med lätthet	easily
easiness	easiness
östra	orient
påsk	ostern
lätt	leicht
äta	essen
eatable	eatable
äter	eats
ebenholts	ebony
original/originell	eccentric
eccentricity	eccentricity
ecclesiastic	geistlich
eko	echo
månförmörkelse/förmörka	eclipse
ecologic	ecologic
miljöforskare	ecologist
miljöforskning	ecology
nationalekonomi	economics
ecru	ecru
åtta	acht
arton	achtzehn
eighteenth	eighteenth
eightfold	eightfold
åttonde	eighth
åttitalet	eighties
eightieth	eightieth
åttio	achtzig
eightyfold	eightyfold
einsteinium	einsteinium
varje	jede
utropa	ausrufen
ejaculated	ejaculated
ejaculates	ejaculates
ejaculating	ejaculating
utrop	ejaculation
ejaculations	ejaculations
ejaculatory	ejaculatory
tar ut	eject
ejectable	ejectable
ejecting	ejecting
ejection	ejection
ejector	ejector
ejectors	ejectors
genomarbeta/utveckla	elaborate
elaborated	elaborated
genomarbetar/utvecklar	elaborates
elaborating	elaborating
elaboration	ausarbeitung
elaborations	elaborations
hiss	aufzug
elva	elf
eleventh	eleventh
avlägsna	ausschalten
slut/avsluta	beschließen
miljö	milieu
sändebud	bote
avund/avundas	beneiden
avund/avundas	beneiden
rulltrappa	rolltreppe
etablera	gründen
händelse	begebenheit
eventual	etwaig
eventuellt	gegebenfalls
någonsin	ehemals
evergreen	evergreen
ständig/evig	endlos
varje	jede
överallt	allenthalben
vräkning	eviction
bevis	erweis
utropa	ausrufen
fable	fabel
fables	fables
tyg	gewebe
fabricant	fabricant
uppfinna/förfalska	anfertigen
fabricated	fabricated
fabricates	fabricates
fabricating	fabricating
påhitt/lögn	fabrication
fabrications	fabrications
fabricator	fabricator
fabricators	fabricators
tyger	fabrics
fabulist	fabulist
fabulous	fabulous
facade	fassade
facades	facades
faceless	faceless
faceplate	faceplate
facet	facet
skämtsam	scherzhaft
skämtsam	scherzhaft
facetiously	facetiously
ansikts-	facial
facies	facies
facile	geläufig
underlätta	erleichtern
främjandet	facilitated
facilitates	facilitates
facilitating	facilitating
möjligheter	möglichkeiten
hjälpmedel	hilfsmittel
vara vänd mot	facing
faksimil	facsimile
faktum	tatsache
parti/partigrupp/split	fraktion
faktor	factor
factorial	fakultaet
factorials	factorials
fabriker	factories
factorization	factorization
factorizations	factorizations
factorize	factorize
factorized	factorized
faktorer	factors
fabrik	fabrik
fakta	facts
factual	faktisch
facultative	facultative
facultatively	facultatively
faculties	faculties
förmåga/fakultet	fakultät
vurm/mani	fad
tyna	erblassen
tynade	faded
fader	fader
faders	faders
fading	fading
faery	faery
faience	faience
fela	unterlassen
svimma/svag	flau
faintly	faintly
skaplig/ärlig	basar
tämligen/ärligt	ziemlich
fe	fee
trogen	gläubig
troget	faithfully
modern/elegant	fashionable
snabbt	schnell
fäste	fastener
kräsen	wählerisch
fet	dick
ödesdigert/dödlig	fatal
fatalism	fatalism
svår olycka	fatality
fatally	fatally
ödet	bestimmung
fisk	fischen
fishable	fishable
fishbowl	fishbowl
fished	fished
fisher	fisher
fisheries	fisheries
fiskare	fisherman
fishermen	fishermen
fishers	fishers
fishery	fishery
fishes	fishes
fisket	angeln
fishtail	fishtail
klyvning	fission
fissionable	fissionable
klyfta/klyvning	fissure
knytnäve	faust
fisted	fisted
fistful	fistful
fem	fünf
fivefold	fivefold
laga	anberaumen
fixation	fixation
fixations	fixations
fixity	fixity
fast tillbehör	fixture
fixtures	fixtures
fjord	fjord
fjords	fjords
flygtur	flug
diskett	diskette
fluently	fluently
fot	fuß
fotboll	fußball
glömma	vergessen
glömskt	vergeßlich
glömska	forgetfulness
forgivable	forgivable
forgivably	forgivably
förlåt	entschuldigen
förlåtelse	forgiveness
forgives	forgives
forgiving	forgiving
avstå från/uppge	forgo
forgoes	forgoes
glömd	forgotten
övergiven/hopplös	forlorn
formaldehyde	formaldehyde
fyra	vier
räv	fuchs
fraktal	fractal
fraktaler	fractals
fraktion	fraktion
fractionate	fractionate
broderlig	fraternal
fraternize	fraternize
vän	freundin
vänskap	freundschaft
frans/kanta	fringe
groda	frosch
frogs	frogs
från	als
fram	front
knullad/knullade	fucked
fudge	fudge
fugue	fugue
fulgurant	fulgurant
rädsla	angst
roligaste	funniest
kul	drollig
prat	gab
gabardine	gabardine
gabber	gabber
gabbing	gabbing
gaberdine	gaberdine
hjälpmedel	hilfsmittel
glädje	freuen
glatt	frohes
vinna	errungenschaft
vunnit	gained
gaining	gaining
gala	gala
galactic	galactic
lysande samling	galaxy
tapper/artig	brav
gallantly	gallantly
gallantry	gallantry
galleries	galleries
galleri/läktare	galerie
gallon	gallon
galopp/galoppera	galopp
galloped	galloped
galloping	galloping
galvanic	galvanic
galvanism	galvanism
uppliva/galvanisera	galvanize
galvanized	galvanized
spel	aufführung
spel	spiels
vitlök	knoblauch
gas/gasa/prat/bensin	gas
bensin	benzin
ghostwriter	ghostwriter
present	angebinde
gåvor	gifts
gå/starta	fahren
mål	ziel
mål	ziel
get	ziege
gud	gott
gudinna	goddess
gudinnor	goddesses
godfather	gevatter
golf	bucht
golfer	golfer
golfers	golfers
golfs	golfs
bra	gut
bra	gut
adjö	adieu
godnatt	goodnight
gopher	gopher
klänning/dräkt	kleid
gripa tag i	greifen
stigning	gradient
gradvis	allmählich
språklära	grammatik
druva	traube
grapefruit	die grapefruit
habilitated	habilitated
habilitation	habilitation
vana	angewohnheit
habitant	habitant
habitants	habitants
naturlig hemvist	habitat
boning/boningsplats	hausen
sed/sedvanlig	habitual
hade	hatte
hand	einhändigen
huvud	führen
heats	heats
himmelskt	himmel
tung	schwer
hectare	hectare
hectares	hectares
hectoliter	hectoliter
igelkott	igel
bekymra sig om	heed
häl/klack/klacka	ferse
heeler	heeler
heels	heels
höjd	höhe
höll	hielt
helices	helices
helvete	dschehenna
hallå/hej	hello
roder/styre	lenkrad
hjälm	helm
hjälp	hilfe
hampa	hanf
höna	huhn
hjord/skock	herd
här	hierher
häger	reiher
höfter	hips
träff	hauen
hockey	hockey
hogwash	hogwash
holidayer	holidayer
ledigheter	holidays
hem	nach hause
hemlösa	homeless
hem	heim
hus	haus
is	eis
instancing	instancing
internship	internship
stöt/stöta/sticka	jab
rotvälska/pladder/pladdra	jabber
jabberwocky	jabberwocky
jabberwocky	jabberwocky
domkraft	bube
schakal	schakal
jackals	jackals
åsnehingst	jackass
kaja	jackdaw
jacka/rock	jacke
jacka/rock	jacke
jackknife	jackknife
pott	jackpot
hästkrake/jade	strapazieren
utsliten/blaserad	abgenutzt
jag	jag
ojämn	uneben
fängelse	gefängnis
fängelse	gefängnis
jailbreak	jailbreak
jailed	jailed
fångvaktare	jailer
jailing	jailing
jailor	jailor
fängelser	jails
rishög	jalopy
klämma/blockera/sylt	konfitüre
klämma/blockera/sylt	konfitüre
karm	jamb
packad	jammed
packad	jammed
gnissla/oljud	jangle
portvakt	der hausmeister
portvakt	der hausmeister
burk/gräla/gnissla	jar
burk/gräla/gnissla	jar
burk/gräla/gnissla	jar
rotvälska/jargong	jargon
jasmin	jasmine
gulsot	jaundice
utfärd	jaunt
ogenerad/nonchalant	jaunty
spjut	javelin
käke	kiefer
käkar	maul
nötskrika	eichelhäher
jazz/snack/pigga upp	jazz
jazzig/gräll	jazzy
svartsjuk	eifersüchtig
avundsjuka	eifersucht
hån/håna	jeer
hån/håna	jeer
gelé	gelee
jellyfish	die qualle
äventyra	jeopardize
äventyra	jeopardize
ryck/rycka/stöt	erschüttern
ryck/rycka/stöt	erschüttern
tysk	deutschem
tröja/ylletröja	jersey
tröja/ylletröja	jersey
skämt/skämta	scherzen
skämtare	hanswurst
skämtare	hanswurst
stråle/låga/jet	jet
stråle/låga/jet	jet
kasta överbord	jettison
pir/kaj/brygga	jetty
juvel	gemme
jeweler	jeweler
jewelery	jewelery
jewelry	jewelry
juveler	jewels
klyvare/streta emot	jib
klyvare/streta emot	jib
ögonblick	augenblick
jigg	jig
lövsåg	jigsaw
heligt krig	jihad
trolös/kvinna/svika	jilt
klirra/klirrande	klimpern
klirra/klirrande	klimpern
klirra/klirrande	klimpern
dra olycka	jinx
nervositet/panik	nervosität
arbete	arbeit
arbete	arbeit
arbete	arbeit
arbetslös	arbeitslos
jockej	jockey
skämtsam	jovial
glad/glättig/munter	jocund
jodhpur	jodhpur
knuffa/lunka	jog
jogging	jogging
gå med	verbinden
gå med	verbinden
joinable	joinable
gått med	joined
möbelsnickare	joiner
snickeri	joinery
skarv	fuge
skarv	fuge
skarv	fuge
gemensamt	gemeinsames
skämta	scherzen
skämta	scherzen
skojade	joked
skämtare	joker
på skämt	jokingly
på skämt	jokingly
glad/väldigt	jolly
skaka/skakning	erschüttern
skaka/skakning	erschüttern
jonquils	jonquils
knuffa/knuffas	jostle
jota/annotera	jot
jota/annotera	jot
dagbok/tidning	journal
dagbok/tidning	journal
journalistik	journalism
journalist	journalist
journalister	journalists
resa	reise
resa	reise
gemytlig	gemütlich
jovially	jovially
glädje	freude
glad/glädjande	joyful
glädjelös	joyless
joyously	joyously
jubileum	jubelfeier
domare	richten
domare	richten
dömts	judged
omdöme	urteil
rättslig	judicial
domarna	judiciary
judo	judo
krus/tillbringare	kanne
krus/tillbringare	kanne
krus/tillbringare	kanne
gudabild	juggernaut
jonglera	gaukeln
jonglör	jongleur
halsblodåder	jugular
saft	saft
saftlös	juiceless
juicier	juicier
juiciest	juiciest
saftig	juicy
jukebox	jukebox
röra	bewegen
klumpeduns	jumbo
hoppa	springen
hoppade	jumped
nervös	jumpy
knutpunkt	union
knutpunkt	union
jungel	jungle
yngre/lägre	junior
enbuske	juniper
lump/skräp/djonk	junk
lump/skräp/djonk	junk
lump/skräp/djonk	junk
lump/skräp/djonk	junk
junkers	junkers
junkers	junkers
knarkare	junkie
knarkare	junkie
junkyard	junkyard
juridic	juridic
rättskipning	jurisdiction
rättslärd	jurist
jurymedlem	juror
jurors	jurors
jury/nämnd	geschworene
bara	billig
rättvisa/rätt	gerechtigkeit
rättfärdigat	justified
rättfärdiga	justify
rättvist	justly
sticka fram	jut
ungdomlig	juvenile
placera vid sidan	juxtapose
kål	kohl
kaleidescope	kaleidescope
kaleidoscope	kaleidoscope
känguru	kängeruh
karat	karat
karate	karate
kayak	kayak
kebab	kebab
köl	kiel
fortsätta/behålla	bewahren
behåller	keeps
suvenir	andenken
kagge/kutting	keg
kagge/kutting	keg
hundkoja/hundgård	kennel
hundkoja/hundgård	kennel
huvudduk	kerchief
kärna/korn	kern
kärna/korn	kern
kärna/korn	kern
fotogen	kerosene
ketchup	ketchup
kittel	kessel
tangent	schlüssel/taste
tangent	schlüssel/taste
tangent	schlüssel/taste
tangentbord	tastatur
keyhole	keyhole
keying	keying
grundton/klav	keynote
keypad	keypad
khaki	khaki
spark/sparka/kick	stampfen
spark/sparka/kick	stampfen
motreaktion	kickback
kicked	kicked
kicker	kicker
kickoff	kickoff
kicks	kicks
unge	zicklein
unge	zicklein
unge	zicklein
kiddies	kiddies
kiddies	kiddies
kiddies	kiddies
röva bort	kidnap
kidnaped	kidnaped
kidnaper	kidnaper
kidnaper	kidnaper
kidnapers	kidnapers
kidnaping	kidnaping
kidnapped	kidnapped
kidnapper	kidnapper
kidnappers	kidnappers
kidnapping	kidnapping
kidnappings	kidnappings
njure	niere
kidneys	kidneys
kidneys	kidneys
ungar	kids
ungar	kids
ta bort	ermorden
ta bort	ermorden
mördare	killer
mördare	killer
killers	killers
dödande	killing
dödande	killing
killings	killings
killjoy	killjoy
brännugn	herd
kilo	kilogramm
kilogram	kilogram
kilohertz	kilohertz
kiloliter	kiloliter
kilometer	kilometer
kilowatt	kilowatt
kilt	kilt
släkt	verwand
vänlig/sort	freundlich
vänlig/sort	freundlich
vänlig/sort	freundlich
lekskola	kindergarten
lekskola	kindergarten
lekskola	kindergarten
lekskola	kindergarten
kindhearted	kindhearted
kindhearted	kindhearted
kindheartedness	kindheartedness
tända	zünden
tända	zünden
kindlessly	kindlessly
kindlessly	kindlessly
kindliness	kindliness
kindliness	kindliness
välvilligt	kindly
välvilligt	kindly
välvilligt	kindly
välvilligt	kindly
vänlighet	freundlichkeit
vänlighet	freundlichkeit
släktskap	kindred
släktskap	kindred
vänliga	freundlicher
vänliga	freundlicher
kung	könig
kungarike	königreich
kungarike	königreich
kungariken	kingdoms
kingfisher	eisvogel
konungslig	kingly
kungar	kings
krullig/excentrisk	kinky
kiosk	kiosk
rökt fisk/rökt sill	kipper
kysser/kyss	küssen
kysser/kyss	küssen
kysser/kyss	küssen
kysser/kyss	küssen
kyssar	kisses
kyssar	kisses
utrustning/packning	bausatz
utrustning/packning	bausatz
kök	küche
kokvrå	kitchenette
kitchens	kitchens
kitchenware	kitchenware
kitchenware	kitchenware
glada/drake	drachen
släktingar	kith
kiting	kiting
kattunge	kätzchen
kattungar	kittens
kitty	kitty
kiwi	kiwi
kiwi	kiwi
kleenex	kleenex
kleenex	kleenex
kleptomania	kleptomania
kleptomaniac	kleptomaniac
knep/vana	knack
knep/vana	knack
ryggsäck	tornister
knåda	kneten
kneadable	kneadable
kneader	kneader
knä	knie
knäskål	kneecap
knäböjer	kneel
knäböjer	kneel
knäande	kneeling
knäande	kneeling
kneepad	kneepad
knäböjde	knelt
knäböjde	knelt
dambyxor	knickers
knickknack	knickknack
knickknack	knickknack
kniv	messer
kniv	messer
knifes	knifes
knifing	knifing
riddare/adelsman/adla	kämpe
riddare/adelsman/adla	kämpe
knighted	knighted
knighthood	knighthood
knightly	knightly
knights	knights
sticka/rynka	stricken
sticka/rynka	stricken
sticka/rynka	stricken
knitted	knitted
stickning	knitting
trikåvaror	knitwear
knivar	knives
vred	gefäß
vred	gefäß
knölig	knobby
knobs	knobs
slå	klopfen
knockdown	knockdown
knockout	knockout
knut/knop	knoten
knots	knots
knölig	knotted
knölig/kvistig	knotty
veta	kennen
knower	knower
knowhow	knowhow
knowhow	knowhow
veta	weiss
medvetet	knowingly
medvetet	knowingly
kunskap	begriff
kunskap	begriff
kunnig	kundig
kända	known
vet	weisst
knoge	knuckle
knoge	knuckle
knucklebone	knucklebone
knogar	knuckles
koala	koala
koala	koala
kosher	kosher
kraut	kraut
kraut	kraut
krauts	krauts
kudzu	kudzu
labb	lab
arbeta	arbeiten
laborer	arbeiter
laborer	arbeiter
laborers	laborers
snöre/snöra/spets/spetsar	spitze
laceration	laceration
lacerations	lacerations
avsaknad	fehlen
lackadaisical	lackadaisical
lakej	bedienter
bristen	lacking
lackluster	lackluster
laconic	laconic
laconically	laconically
fernissa	firnissen
fernissa	firnissen
pojke	junge
damer	damen
dam/kvinna	dame
ladybird	ladybird
ladybug	marienkäfer
sjö	see
sjöar	lakes
lamm	lamm
lambs	lambs
laminated	laminated
laminates	laminates
lampa/lykta	lampe
språk	sprache
skratta	lachen
läder	ledern
lämna	abreisen
läspulpet	pult
föreläsning/föreläsa	vortrag
föreläsare	lektor
hylla	regal
huvudbok/liggare	ledger
lä/läsida	lee
ben	bein
giltiga	legal
laglighet	legality
legalisera	legalize
lagligt	legally
påvlig legat	legate
legation	legation
legend/sägen	legende
legendariska	legendary
legion	legion
brev	epistel
brev	epistel
brev	epistel
gilla/som	achten
leva	hausen
älska/kärlek	gern haben
älska/kärlek	gern haben
älskare	freier
tur	glück
lunch/luncha	lunch
mamma	mutti
mamma	mutti
maam	maam
maam	maam
maam	maam
makaber	macabre
makaber	macabre
macabrely	macabrely
makadam	macadam
makadam	macadam
macadamize	macadamize
macadamize	macadamize
macadamized	macadamized
macadamized	macadamized
macadamizes	macadamizes
macadamizes	macadamizes
macadamizing	macadamizing
macaque	macaque
macaque	macaque
macaroni	makkaroni
macaronies	macaronies
macaroon	macaroon
macaw	macaw
spikklubba/spira	mace
macerate	macerate
macerated	macerated
maceration	maceration
macerations	macerations
maces	maces
machete	machete
intrig	machination
machined	machined
machineries	machineries
maskiner	maschinerie
maskiner	machines
machinist	machinist
machinists	machinists
machismo	machismo
macho	macho
macrocephalic	macrocephalic
macrocosm	macrocosm
macroeconomics	macroeconomics
macroevolution	macroevolution
macroevolutionary	macroevolutionary
macroinstruction	macroinstruction
macromolecular	macromolecular
macromolecule	macromolecule
macromolecules	macromolecules
macropathological	macropathological
macropathology	macropathology
macrophage	macrophage
macrophages	macrophages
macrophagic	macrophagic
macroprocessor	macroprocessor
macroscopic	macroscopic
macrosimulation	macrosimulation
macrostructure	macrostructure
maculate	maculate
maculated	maculated
maculates	maculates
maculation	maculation
maculations	maculations
vansinnig	irre
vansinnig	irre
min fru/fröken	frau
madams	madams
maddened	maddened
gjorda/gjort	made
gjorda/gjort	made
mademoiselle	mademoiselle
mademoiselles	mademoiselles
maestro	meister
mafioso	mafioso
tidning	zeitung
magiskt	magie
trollkarl	zauberer
magicians	magicians
magistral	magistral
magistrally	magistrally
magistrature	magistrature
magma	magma
jag/mig	mir
mjöd/äng	mead
äng	anger
äng	anger
meadowland	meadowland
ängen	meadows
meager	mager
meagerly	meagerly
mager/torftig	meagre
mål	mehl
meals	meals
mena/betyda/tarvlig	beabsichtigen
slingra sig	sich schlängeln
meaningless	meaningless
betydelse	bedeutung
menas	bedeutet
kött	fleisch
meats	meats
meatball	meatball
meatballs	meatballs
mekaniker	mechaniker
mechanician	mechanician
mekanism	mechanism
mekanismer	mechanisms
medalj	denkmünze
medaljong	medallion
medallions	medallions
mediatrice	mediatrice
mediatrix	mediatrix
medic	medic
medicinsk/läkar-	medizinisch
medically	medically
medicament	medicament
medicaments	medicaments
medicinal	medicinal
medicin	medizin
medicines	medicines
medico	medico
medicolegal	medicolegal
medics	medics
medeltida	medieval
medievalist	medievalist
medievalists	medievalists
medelmåttig	mediocre
mediocrity	mediocrity
planera/meditera	erwägen
meditates	meditates
meditation	meditation
meditations	meditations
meditative	meditative
mellan	mittels
medlar	medlar
blandning/brokig	medley
medleys	medleys
medulla	medulla
medusae	medusae
ödmjuk	meek
meekly	meekly
meekness	meekness
meerschaum	meerschaum
megabyte	megabyte
megabytes	megabytes
megacycle	megacycle
megahertz	megahertz
megalith	megalith
megalithic	megalithic
megalomania	megalomania
megalomaniac	megalomaniac
megalomaniacal	megalomaniacal
megaphone	megaphone
melancholia	melancholia
melancholic	melancholic
melange	melange
melodic	melodic
melodies	melodies
melodious	melodious
melodrama	melodram
melodramas	melodramas
melodramatic	melodramatic
melodi	melodie
melon	melone
meloner	melons
melted	melted
medlem	anhänger
medlemmars	members
membran	membrane
membranes	membranes
membranous	membranous
memoir	memoir
memoarer	memoirs
minnesvärd	memorable
minnen	memories
memorera	memorize
memorerat	memorized
karlar	männer
hot	bevorstehen
menagerie	menagerie
menageries	menageries
menhir	menhir
meningitis	meningitis
meniscus	meniscus
menopause	menopause
menstrual	menstrual
menstruation	menstruation
menstruations	menstruations
sjäslig/sinnes-	mental
mentality	mentality
menthol	menthol
nämna	nennen
meny	menü
meow	meow
meowing	meowing
meows	meows
mephitic	mephitic
handels-/affärs-	mercantile
mercantilism	mercantilism
mercenaries	mercenaries
legosoldat	mercenary
köpman	händler
köpmän	merchants
kvicksilver	quecksilber
barmhärtighet	barmherzigkeit
meridian	meridian
meridional	meridional
förtjänst/förtjäna	verdienen
meritocracy	meritocracy
meriter	merits
sjöjungfru	die meerjungfrau
mermaids	mermaids
god	wohlgemut
meddelande	auskunft
meddelanden	mitteilungen
messiahs	messiahs
messianska	messianic
stöna	ächzen
stönade	moaned
stönande	moaning
stönar	moans
vallgrav	moat
moats	moats
mob	mob
mock	äffen
mocked	mocked
hån	spott
modal	modal
månljus/månsken	mondschein
älg	elch
naiv	naiv
naively	naively
naken	bloß
namn/döpa	name
namngiven	named
anonym	nameless
nämligen	zwar
nämligen	zwar
namn/döper	names
nationell/riks-	national
nationalism	nationalism
nationalist	nationalist
infödd	angeboren
naturlig	natürlich
naturalisera	naturalize
naturligtvis	natürlich
neap	neap
i närheten	beiläufig
närmare	näher
försumma	unterlassen
neighbor	nachbar
neighbors	neighbors
nätverk	garn
för nätverk	networked
nätverk	netzwerk
nio	neun
nitton	neunzehn
nittonde	nineteenth
nineties	nineties
ninetieth	ninetieth
nittio	neunzig
ninetyfold	ninetyfold
ninth	ninth
niobium	niobium
nypa/frostskada	nip
smörjkopp	zitze
nipplar	nipples
nips	nips
nirvana	nirvana
nitrat	nitrate
nitrated	nitrated
nitrates	nitrates
nitrating	nitrating
nitration	nitration
nitrations	nitrations
salpeter	nitric
nitrera	nitride
kväve	stickstoff
nitroglycerin	nitroglycerin
nitroglycerine	nitroglycerine
adlig/ädel	edel
adelsman	adeliger
noblemen	noblemen
nobleness	edelmut
ingen	keine
noctambulism	noctambulism
noctambulist	noctambulist
nocturn	nocturn
nocturnally	nocturnally
nu	nu
nu för tiden	heutzutage
noway	noway
noway	noway
idiot	oaf
oafishness	oafishness
ek	eiche
åra	ruder
oarsman	oarsman
oas	oase
havre	hafer
ed/svordom	eid
havremjöl	oatmeal
förstockad	obdurate
lydnad	obedience
lydig	folgsam
obelisk	obelisk
fet	fett
överdriven fetma/dästhet	obesity
ocean	ozean
en	ein
apelsin	apfelsine
oranges	oranges
kretslopp	orbit
orbital	orbital
orbits	orbits
orkester	orchester
orchestral	orchestral
orchestras	orchestras
orchestrated	orchestrated
beställa/beställning	befehlen
beställd	ordered
organism	organismus
organisms	organisms
organist	organist
organists	organists
organisation	einrichtung
organisationer	organizations
organisera	einrichten
organiserad	organized
organ	organs
orgasm	orgasm
orgasmer	orgasms
orgies	orgies
orgie/utsvävning	orgie
orienten	orient
orientable	orientable
orientering	orientation
orientations	orientations
orienterad	oriented
orients	orients
öppning	orifice
orifices	orifices
orificial	orificial
ursprung	ursprung
original/ursprunglig	ursprünglich
äkthet	originality
ursprunligen	originally
originals	originals
origins	origins
ornamental	ornamental
ornithology	ornithology
orthodox	orthodox
orthodoxes	orthodoxes
orthogonal	orthogonal
fart	schreiten
fart	schreiten
pachyderm	pachyderm
stilla	stillen
pacifically	pacifically
pacification	pacification
pacifications	pacifications
pacificist	pacificist
pacifier	pacifier
pacifism	pacifism
pacifist	pazifist
lugna/stilla	pacify
lugna/stilla	pacify
paket	packen
paket	packen
packaged	packaged
packaged	packaged
packad	packed
litet paket	bündel
frakt	packing
fördrag	pact
pacts	pacts
kudde	block
stoppning	padding
paddel/paddla	paddeln
hästhage/sadelplats	paddock
hänglås	vorhängeschloss
hänglås	vorhängeschloss
padrone	padrone
paella	paella
hedning/hednisk	pagan
hedningar	pagans
festtåg	pageant
pageantry	pageantry
betalad	paid
hink	eimer
smärta	schmerz
pained	pained
smärtsam	painful
smärtsam	painful
smärtsamt	painfully
noggrann	painstaking
måla	färben
måla	färben
paintbrush	pinsel
målare	maler
painters	painters
tavla/målning	bild
målar	paints
par	paar
pyjamas	schlafanzug
vän	genosse
vän	genosse
palats	palast
smaklig	palatable
palaver	palaver
blek	blaß
färgkarta	palette
bårtäcke/äcklas	pall
brits/hård bädd	pallet
pallette	pallette
pallor	pallor
handflata	handfläche
handflata	handfläche
kännbar	palpable
kännbar	palpable
usel	paltry
broschyr	broschüre
panna/kastrull/skål	pan
panacea	panacea
panama	panama
pancake	fladen
panda	der panda
pandemonium	pandemonium
fönsterruta	pane
ruta/fält/panel	paneel
paneling	paneling
panelling	panelling
smärta/styng	pang
få panik	panik
få panik	panik
panicky	panicky
panorama	panorama
pensé	stiefmütterchen
flämta/flämtning	pant
panther	panther
trosor	unterhose
skafferi	speisekammer
byxor	beinkleid
papa	papa
papper/tidning	dokument
pocketbok	broschüre
parameter	parameter
passer	passer
lidelse/vrede	glut
passionerat	passionately
passiv	passive
passivity	passivity
lösenord	passwort
passwords	passwords
förbi	vergangenheit
pasta	pasta
pectorals	pectorals
egendomlig	befremdend
ånger	penitence
penitences	penitences
penitency	penitency
ångerfull	penitent
pentadactyl	pentadactyl
pentadactylism	pentadactylism
pi	pi
pianist	pianist
pianistic	pianistic
bild	ansicht
bilder	pictures
tårt	pastete
pies	pies
gris	schwein
pigeonhole	abteilung
pigment	pigment
pigmentation	pigmentation
pigments	pigments
pigs	pigs
lots/lotsa/pilot	lotsen
pilots	pilots
pilule	pilule
barrträd/tall/tyna/tyna bort	föhre
ananas	ananas
pineapples	pineapples
pines	pines
rosa	rosa
fickan	tasche
plånbok	brieftasche
pocketbooks	pocketbooks
pockets	pockets
podium	podium
pogrom	pogrom
pogroms	pogroms
pekare	zeiger
pointillism	pointillism
pointillist	pointillist
pointilliste	pointilliste
pointillistic	pointillistic
gift	vergiften
giftig	giftig
poisonousness	poisonousness
poisons	poisons
polar	polar
polarities	polarities
polarity	polarity
polarize	polarize
polarized	polarized
polemical	polemical
polemically	polemically
polemicize	polemicize
polisen	polizei
polis	polizist
polis	polizist
polis	polizist
policemen	policemen
policemen	policemen
policemen	policemen
policewoman	policewoman
policewomen	policewomen
politik	polize
glans/polera/polska	polnisch
glans/polera/polska	polnisch
artig	artig
politely	politely
artighet	politeness
politisk	politisch
politiskt	politically
politiker	politician
politicians	politicians
politik	politik
polka	polka
förorenande ämne	pollutant
orena/förorena	pollute
polluted	polluted
polluter	polluter
miljöförstöring	pollution
polonium	polonium
poltergeist	poltergeist
polyandrous	polyandrous
polyandry	polyandry
hälla	gießen
tjura	schmollen
fattigdom	armut
krut/pulver/puder	pudern
powdery	powdery
kraft	gewalt
kraftfull	gewältig
powerless	powerless
powwow	powwow
practicability	practicability
genomförbar	gangbar
praktisk	praktisch
bedja	beten
bön	gebet
böner	prayers
praying	praying
praying	praying
predika	predigen
predika	predigen
preacher	preacher
preacher	preacher
preachers	preachers
preachers	preachers
predikanter	preaches
predikanter	preaches
preachify	preachify
predikandet	preaching
predikandet	preaching
predikandet	preaching
preachy	preachy
preachy	preachy
preamplifiers	preamplifiers
prearrange	prearrange
prearrange	prearrange
prince	fürst
princedom	princedom
princely	princely
princes	princes
princess	fürstin
huvudsaklig	hauptsächlich
huvudsaklig	hauptsächlich
principalities	principalities
furstendöme	fürstentum
principally	besonders
principally	besonders
principals	principals
princip	grundsatz
principles	principles
skriva ut	drucken
skriva ut	drucken
skriva ut	drucken
utskriven	ausgedruckt
skrivare	drucker
skrivare	drucker
priorities	priorities
priorities	priorities
prioritet	priorität
bevisa	begründen
pulsera	puls
pulverizable	pulverizable
pulverizables	pulverizables
pulverization	pulverization
pulverize	mahlen
pulverized	pulverized
pulverizer	pulverizer
pulverizers	pulverizers
pulverizes	pulverizes
pulverizing	pulverizing
puma	puma
pump	pumpen
trycka	dringen
pushchair	pushchair
trycker/tryckande	pushing
placera/uttrycka	legen
putdown	putdown
putout	putout
putrefaction	putrefaction
vaktel/bäva/förlora modet	wachtel
quails	quails
skälva/skalv	quake
kvalitet	art
oro/illamående	qualm
samvetskval	qualms
mängd	menge
gräl	disput
byte/stenbrott	quarry
fjärdedel	quartier
quarterdeck	quarterdeck
quarterfinal	quarterfinal
drottningen	königin
underlig	wunderlich
undertrycka/kuva	erdrosseln
släcka/undertrycka	quench
gnällig	querulous
förfrågan	anfrage
sök/sökande	nachsuchung
fråga	frage
köa	queue
rida på ord/slingra sig	schikanieren
snabb	geschwind
quicklime	quicklime
snabbt	flugs
kvicksand	quicksand
quicksilver	quecksilber
tyst	fromm
quieten	quieten
tystlåtet	quietly
gåspenna	quill
sängtäcke	steppen
sarkasm/besynnerlighet/snirkel	quirk
sluta	abdanken
ganska	sehr
kvot	quote
citat	zitat
ange	anführen
r	r
rabbet	rabbet
rabbi	rabbiner
rabbinic	rabbinic
kanin	kaninchen
kaniner	rabbits
slödder	gesindel
galen/arg	rabid
rabies	tollwut
raccoon	raccoon
tävling/ras	abkunft
tävlingshäst	racehorse
racemic	racemic
racer	racer
races	races
rachis	rachis
rachitic	rachitic
rachitis	rachitis
racialism	racialism
racialist	racialist
racialistic	racialistic
racing	racing
racism	racism
racist	racist
ställning	arrak
oväsen/bedrägeri/racket	schläger
oväsen/bedrägeri/racket	schläger
radar	radar
radars	radars
radio	radio
läsa	lesen
läsbarhet	lesbarkeit
läsbar	readable
läsare	reader
läsarna	readers
readership	readership
readership	readership
gärna	gern
gärna	gern
gärna	gern
villighet	readiness
villighet	readiness
läser	lesung
läser	lesung
läser	lesung
readings	readings
readings	readings
revidera	readjust
readjusts	readjusts
readjusts	readjusts
avläsning	readout
avläsning	readout
readouts	readouts
läser	reads
klar	bereit
klar	bereit
klar	bereit
på nytt bekräfta	reaffirm
på nytt bekräfta	reaffirm
reaffirms	reaffirms
reaffirms	reaffirms
reagent	reagent
riktig	effektiv
riktig	effektiv
riktig	effektiv
realisable	realisable
realism	realism
realist	realist
realistiskt	realistic
realistiskt	realistic
realistically	realistically
verkligheten	wahrheit
förstå	begreifen
verkligen	tatsächlich
reporter	reporter
representerar	abbilden
begäran/efterfråga	bitten
begäran/efterfråga	bitten
begäran/efterfråga	bitten
väg	bahn
vägar	roads
roadwork	roadwork
rövare	freibeuter
rotting	rotting
sabbat	sabbat
sabbat	sabbat
sabbatic	sabbatic
sabbats-	sabbatical
saber	saber
sabin	sabin
sobel	sable
sabot	sabot
sabotage/sabotera	sabotage
saboterad	sabotaged
sabotage	sabotages
sabotör	saboteur
sabra	sabra
sabras	sabras
saccade	saccade
sackarin	saccharin
sackarin	saccharine
saccharose	saccharose
sacerdotal	sacerdotal
sacerdotally	sacerdotally
portionspåse	sachet
säck/avskeda/plundra	abdanken
säck/avskeda/plundra	abdanken
sackcloth	sackcloth
sacked	sacked
sackful	sackful
sacks	sacks
sakrament	sakrament
sakramental	sacramental
sacraments	sacraments
sacre	sacre
helig	heilig
offer/uppoffring/uppoffra	erbieten
uppoffrat	sacrificed
sacrifices	sacrifices
helgerån	sakrilegium
ledsen	düster
göra ledsen	sadden
sadder	sadder
saddest	saddest
sadel	sattel
saddlebag	saddlebag
saddlebags	saddlebags
saddlebow	saddlebow
saddlecloth	saddlecloth
saddled	saddled
saddleless	saddleless
saddler	saddler
saddlery	saddlery
saddles	saddles
saddletree	saddletree
sadism	sadism
sadist	sadist
sadistiska	sadistic
sadistically	sadistically
sadists	sadists
ledsamt	sadly
sorg	betrübnis
safari	safari
säker	sicher
safecracker	safecracker
safecracking	safecracking
skydd/säkra	safeguard
safeguarded	safeguarded
safeguards	safeguards
säkrare	safer
säkraste	safest
säkerhet	sicherheit
safflower	safflower
saffron	saffron
bågna/sjunka	sag
saga	saga
sagacious	einsichtsvoll
sagaciously	sagaciously
sagaciousness	sagaciousness
skarpsinne/klokhet	sagacity
vis/salvia	salbei
sagely	sagely
sago	sago
saguaro	saguaro
sahib	sahib
sa	sagte
segla	segel
segla	segel
sailable	sailable
sailboat	das segelboat
sailboater	sailboater
sailcloth	sailcloth
sjömän	sailors
sails	sails
sainfoin	sainfoin
helgon/sankt/sankta	heiliger
sainted	sainted
sainthood	sainthood
saith	saith
skull	sake
salability	salability
salacious	salacious
salad	salat
salads	salads
salamander	der salamander
salaried	salaried
salaries	salaries
försäljning	absatz
säljbar	saleable
saleroom	saleroom
salesclerk	salesclerk
salesgirl	salesgirl
saleslady	saleslady
försäljare	ladengehilfe
salesmanship	salesmanship
försäljare	verkäufer
salespeople	salespeople
salesperson	salesperson
salesroom	salesroom
saleswoman	ladenfräulein
saleswomen	saleswomen
framträdande/utskjutande	salient
salthaltig/saltdamm	saline
salinity	salinity
salinometer	salinometer
salinometers	salinometers
saliva	speichel
salivary	salivary
salivate	salivate
salivated	salivated
salivates	salivates
salivating	salivating
salivation	salivation
sallies	sallies
gulblek/sälg	blaß
sallowish	sallowish
lax	lachs
salmons	salmons
salon	aula
salons	salons
salt/salta	salzen
saltwater	saltwater
saltworks	saltworks
saltwort	saltwort
salt	salzen
hälsosam	bekömmlich
salubrity	salubrity
bärga/bärgning	heil
silverbricka	salver
samba	samba
samma	gleiche
sampan	sampan
samphire	samphire
samurai	samurai
samurais	samurais
sand	sand
sandal	sandale
skola	schule
hav/sjö/sjögång	meer
sälja	veräußern
säljare	seller
sellers	sellers
serendipity	serendipity
lugn/fridfull	heiter
sju	sieben
sevenfold	sevenfold
sjutton	siebzehn
seventeenth	seventeenth
seventh	seventh
seventies	seventies
seventieth	seventieth
seventy	siebzig
seventyfold	seventyfold
hugga av/skilja	sever
kännbara/stränga	streng
severed	severed
kännbart	severely
severities	severities
stränghet	severity
avloppsvatten	sewage
kön	geschlecht
sexagenarian	sexagenarian
sexuell	generisch
sexuellt	sexually
nyanser	shades
skugga	schatten
skuggor	shadows
shagreen	shagreen
shah	schah
skaka	erschüttern
shakedown	shakedown
shaken	shaken
skakande/skral/svag	shaky
shaman	shaman
shamanism	shamanism
shampoo	shampoo
shampoos	shampoos
får	hammel
sheepherder	sheepherder
skepp	abfertigen
skepp	abfertigen
skit	mist
sjukt	krank
silver	silber
sjunga	singen
sångare	berufssänger
sjunka	tauchen
sex	sechs
sexton	sechzehn
sixteenth	sixteenth
sixties	sixties
sextio	sechzig
sixtyfold	sixtyfold
storlek	ausdehnung
skridsko/åka skridsko	rochen
skateboard	skateboard
skateboarder	skateboarder
skateboarding	skateboarding
skateboards	skateboards
skater	skater
skaters	skaters
skates	skates
skating	skating
skicklighet	geschicklichkeit
skicklig/yrkesutbildad	geübt
skilless	skilless
skicklig	geübt
himmel	himmel
lärka	lerche
skyscraper	skyscraper
tryne	snout
snö	schneien
snowball	snowball
snöflinga	schneeflocke
snögubbe	snowman
snowstorm	snowstorm
programvara	software
sorrily	sorrily
sorg	betrübnis
sortera	abart
sorterad	sorted
sorter	sorter
själ	gemüt
spectra	spectra
spectrum	spectrum
spekulera	speculate
spekulation	speculation
stapelvara/krampa/märla	klammer
stapled	stapled
stapler	die heftmaschine
staplers	staplers
staples	staples
stjärna	stern
stjärnor	stars
starta	anstellen
stifled	stifled
styrka	stärke
dum	blödsinnig
ämne	subjekt
lyckas/efterträda	erfolg haben
framgång	erfolg
sol	sonne
sunbathe	sunbathe
sunny	sonnig
undertryckt	suppressed
misstänka	argwöhnen
svär	lästern
lapp/etikett	tab
lapp/etikett	tab
tabernakel	tabernacle
bord	tabelle
tablå	tableau
tableaus	tableaus
tableaux	tableaux
bordsduk	tischtucher
tablecloths	tablecloths
tabeller	tables
skrivblock	tabelle
lertavlor	tablets
taboos	taboos
tachometer	tachometer
tachometers	tachometers
tyst/underförstådd	tacit
svans	sterz
skräddare	schneidern
tailored	tailored
tailors	tailors
svansar	frack
uppgift	arbeit
uppgifter	angaben
smaka	schmecken
smakade	tasted
smaklös	fade
riva sönder	zerreißen
riva sönder	zerreißen
riva sönder	zerreißen
riva sönder	zerreißen
teardrop	teardrop
tearful	tearful
tearfully	tearfully
tearfully	tearfully
teargas	teargas
tearjerker	tearjerker
tearless	tearless
tearless	tearless
tearoom	tearoom
tårar	tränen
tårar	tränen
tearstained	tearstained
tearstained	tearstained
reta/retas	tease
reta/retas	tease
reta/retas	tease
teasel	teasel
svår uppgift	teaser
svår uppgift	teaser
teases	teases
teases	teases
teases	teases
teasing	teasing
teasing	teasing
teasingly	teasingly
teasingly	teasingly
teaspoon	teaspoon
teaspoon	teaspoon
teaspoonful	teaspoonful
spene	brust
spene	brust
spene	brust
spene	brust
teatime	teatime
teats	teats
teats	teats
tio	zehn
tendencies	tendencies
benägenhet/tendens	stimmung
tenderfoot	tenderfoot
ömt	zärtlich
thence	daher
thence	daher
thenceforth	thenceforth
thenceforward	thenceforward
theocracy	theocracy
theocratic	theocratic
theodolite	theodolite
teolog	theologe
teologer	theologians
theological	theological
theologically	theologically
teologi	theologie
theorem	theorem
theorems	theorems
teoretisk	theoretical
teoretisk	theoretical
theoretically	theoretically
theoretician	theoretician
theoretician	theoretician
theoreticians	theoreticians
theoreticians	theoreticians
theorist	theorist
theorist	theorist
theorists	theorists
theorists	theorists
theorize	theorize
tjuv	dieb
fastän	obgleich
fastän	obgleich
tänkte	gedanke
tänkte	gedanke
tankfull	thoughtful
thoughtfully	thoughtfully
thoughtfulness	vorsorge
thoughtless	thoughtless
thoughtlessly	thoughtlessly
thoughtlessness	thoughtlessness
tusental	tausend
thousandth	thousandth
klå/tröska	verhauen
klå/tröska	verhauen
tråd	faden
tråd	faden
tråd	faden
trådsliten/banal	threadbare
hot	bedrohung
hota	bevorstehen
threatening	threatening
threateningly	threateningly
tre	drei
tigress	tigress
idag	heute
tå	zehe
tradition	tradition
traditionell	traditionell
spår	geleise
tåg/träna	abrichten
trainee	trainee
tränare	trainer
förrädare	traitor
transaktion	transaction
transalpine	transalpine
transcribe	transcribe
överföring	entern
översätta	übersetzen
översättning	übersetzung
översättare	übersetzer
sända	schicken
träd	baum
lastbil/transportera	lastauto
två	zwei
allestädes närvarande	ubiquitous
ubiquity	ubiquity
juver	euter
usch	ugh
uglier	uglier
ugliest	ugliest
uglify	uglify
uglily	uglily
fulhet	ugliness
otäckt	häßlich
ukulele	ukulele
varigt sår/böld	geschwür
ulcerate	ulcerate
ulcerated	ulcerated
ulceration	ulceration
ulcerative	ulcerative
ulna	ulna
ultimo	ultimo
arbetslöshet	arbeitlosigkeit
ledigt	vacant
utrymma	vacate
semester	ferien
vaccinera	impfen
vaccinated	vaccinated
tomrum	vacuum
vacuumed	vacuumed
slida	vagina
luffare	vagrant
vag/svävande	vague
fåfäng	vergebens
wacky	wacky
vagga/vifta	wag
valnöt	walnuß
magasin	geschäft
magasin	geschäft
warehouses	warehouses
tvätta	spülen
gråta	tränen
gråt	weeping
gråt	weeping
weeps	weeps
gråtmild	weepy
gråtmild	weepy
vivel	weevil
inslag i väv	weft
väga	wägen
väga	wägen
weighing	weighing
weighings	weighings
väger	weighs
vikt	gewicht
weighted	weighted
weighted	weighted
weightily	weightily
weighting	weighting
weighting	weighting
weightless	weightless
weightlessness	gewichtslosigkeit
belastningar	weights
belastningar	weights
tung	schwer
tung	schwer
fördämning/damm	weir
konstig	seltsam
weirdie	weirdie
weirdies	weirdies
weirdly	weirdly
weirdness	weirdness
weirdness	weirdness
weirdo	weirdo
weirdos	weirdos
weirs	weirs
välkommen	willkommen
välkommen	willkommen
välkommen	willkommen
välkommen	willkommen
var	war
fönster	fenster
fönster	fenster
windowpane	windowpane
windowpanes	windowpanes
windows	windows
windstorm	windstorm
vin	wein
vinglas	wineglass
winegrower	winegrower
winemaker	winemaker
winemaking	winemaking
winepress	winepress
wines	wines
winey	winey
vinge/flygel/eskader	fittich
winglet	winglet
blinka	zwinkern
vinter	winter
torka	wischen
tråd/telegram/telegrafera	draht
tråd/telegram/telegrafera	draht
tråd/telegram/telegrafera	draht
wired	wired
trådlös/radio	radio
kabeldragning	wiring
senig/seg	wiry
klokhet	weisheit
klokt	gescheit
kvickhet/kvickhuvud	wisecrack
klokt	wisely
wiser	wiser
önskar	wünschen
önskar	wünschen
wishbone	wishbone
önskar	wünsche
wishful	wishful
häxa	hexe
witches	witches
med	mit
dra tillbaka	zurückziehen
dra tillbaka	zurückziehen
utan	ohne
bevittna	zeuge
bevittna	zeuge
vittnen	witnesses
järv	wolverine
järv	wolverine
värld	welt
världsomspännande	universal
främlingsskräck	xenophobe
främlingsskräck	xenophobia
xenophobic	xenophobic
xerographic	xerographic
xylem	xylem
xylene	xylene
xylophone	xylophone
xylophones	xylophones
xylophonist	xylophonist
xylose	xylose
xylotomic	xylotomic
lustjakt	jacht
segling	yachting
seglare	yachtsman
jak	yak
jams	yamswurzel
gläfsa	yap
gård	hof
tumstock	yardstick
garn/skepparhistoria	yarn
gäspa	gähnen
gäspa	gähnen
gäspande	yawning
ja	ja
år	jahr
årsbok	yearbook
yearlong	yearlong
årlig/årligen	jährlich
årlig/årligen	jährlich
längta	sich ersehnen
längtande	yearning
yearningly	yearningly
år	jahr
jäst	yeast
vråla	heulen
vråla	heulen
gul	gelb
yellowed	yellowed
yellowing	yellowing
yellowish	yellowish
ja	ja
igår	gestern
ännu	noch
idegran	yew
avkastning/vika sig	abtreten
yoga	yoga
yoghurt	yoghurt
yogurt	yogurt
ok	joch
äggula	yolk
du/ni	du/sie
du/ni	du/sie
ung	jung
yngre	jüngere
pojkspoling	jüngling
ungdom	jugend
ungdomlig	youthful
yuppie	yuppie
zabaglione	zabaglione
dumbom	zany
zazen	zazen
iver/nit	eifer
ivrig/nitisk	eifrig
sebra	zebra
zenith	zenit
noll	null
noll	null
krydda/aptit	zest
sicksack	im zickzack gehen
zink	zink
blixtlås	reissverschluss
zodiac	tierkreis
zodiac	tierkreis
zon/bälte	zone
zon/bälte	zone
zoologisk trädgård	zoo
zoologi	zoologie
zoom	zoom
zucchini	zucchini
